%%%%%%%%%%%%%%%%%%%%%%%%%%%%%%%%%%%%%%%%%%%%%%%%%%%%%%%%%%%%%%%%%%%%%%%%%%%%%%%%
%%%%%%%%%%%%%%%%%%%%%%%%%%%%%%%%%%%%%%%%%%%%%%%%%%%%%%%%%%%%%%%%%%%%%%%%%%%%%%%%
%%%%%%%%%%%%%%%%%%%%%%%%%%%%%%%%%%%%%%%%%%%%%%%%%%%%%%%%%%%%%%%%%%%%%%%%%%%%%%%%
%%%%%%%%%%%%%%%%%%%%%%%%%%%%%%%%%%%%%%%%%%%%%%%%%%%%%%%%%%%%%%%%%%%%%%%%%%%%%%%%
%%%%%%%%%%%%%%%%%%%%%%%%%%%%%%%%%%%%%%%%%%%%%%%%%%%%%%%%%%%%%%%%%%%%%%%%%%%%%%%%
################################################################################
################################################################################
PPPPBPPPPPPPPPPPPPPPPPPBPPBPPPBPPPPPPPPPPPPPBBPBPBPPPBBPPPBPPPBPPPPPPPPPPPPPPPPP
PBPPPPPPPPPBBPPPPPPBBPPPPPPPPPPPPPPPPPPPPPPPPPPPPPPPPPPBPPBPPPPPPPPPPBBPPPPBPBPP
PPPPPBPBPBPBPPBPPPPPPPPPBPPPPPPPPPBPPBBPPPPPPPPPPPPPPPPPPPPPBPPPPBPPPBPBBPPPPPPP
BPBPPPPPPPPPBPPPPPPPBPPPPPBPPPPPPPBPPBPPPPBPPPPPPPPPPPBPPPPPPPPBPPPBPPPPBPPBPBPP
PPPBPPPPPPPPPPPPPBPBPPPPPPPPPPPPPPBPBBPPPPPPPPPPPPPBBPPPPPPPPPPBPPPPPPPBPPPBPPPP
PPBPPBPPPPPPPPPPPPPPBPBPPPPPPPPPPPPBPPPBBPPPBPPPPPPPPPPBBPBPPPPPPPPPPPPPPPPPBPPB
PPPPPPPPPPBPPPPPPPPBBPPPBPPPPPPPPPPPPPPPPPPPPBPPPPPBPPPPBPPPPPPPPPPPPPPPPPPPPPPP
PPPPPPPPPPPBPPPPPPPPPPPPPBPPPPPPBPBPPPPPPPPBPPPPPPPPPPPPPPPPPBBBPPBPBBPPPPPPPPPB
PPPPPPPPPPBPBPPPPPPPBPPBPPPPPPPPPPBPPPPPPPPPPBPPPBPBPPBPPPPPPPBBPPPBPPPPPPPPPPPP
PPPPPPPPPPPPPPPBPBPPBBPPPPPPPPPPPPPPBPPPBPPBBPBPBPPPPPPBPPPPPPPPPPPPPPPBPPPPBPPB
BPPBPPBPPPPPPPPPPPPPPPPBPPPPPPPPPPPPPPPPPPPPBPPPPPPBPPPPPPPPPPPPPPPPPBPPPPPPBPPP
PPPBPPPBPBPPPPPPPPPPPPPPPPBPPPPPPPBPPBPBBPPPPPPPBPBBBPBPPPPPBPPPPPPPPPPPPPPPPPPP
BBPPBBPPPPPPPPBBPPPPPPPPPPPPBPPPPPBPPPPPPPPBPPPPPPPPBPPPPPPPPPPPPPPPPPBPPPPPPPPP
PPPPPPPPPPPPBPBBPPPBPPPPPPBPPPPPPPPPPPBPPPBPPPPPPPPPPPPPPPPPBBPPPBPPPPBPPPPPPPPP
PPPPBPPPPPPBPPPPBPPPPPPBPPPPPPPPPPPPPPPPPPPPPPPPPPPBPPPPPPBPPPPBPPPPBPPPPPPPPPPP
PPPPBPPPPPPPPBPBPPPPPBPPBPBPPBBPPPPPBPPPPPPPPPBPPPPPBPPBBPPPPPPPPPPPPPPPPPPPPPPP
PPBPPPPPPPPPPPPPPPPPPPPPPPPPPPBPBPPBPPPPPPPPBPPPPPPPPPPPPPPPPPBPPPPBPPBPBPPPBPPP
BPPPPPPPPPPPPPPPPPPPPPPPPPPPPPPPPBPPPPPPPPPPPPPPPPPPPPPPPPPPPPPPPPPPPBPPPPBPPPPP
PPPPPPBPPBPPBPBPPPBPPPPPPPPPPPPBPPPPPPPPBPPPPPPPBPBPPPPPPPPPPBPPPPPPPPPPPPPPPPPP
PFFPPPPBPPPPPPFPPBFPPPPPBPPOPPPPPPPPPPOPPPPPPPPPBPBPPPPPPPPPFPFPPPPPPPPPPPPPPBPP
PPPPPPPPPPPBPBPPPPPPPOPPBPPPPPPPBPPBOFPPPPBPPPPPPPPPPPPPPPBPPPPPBPFPPPPPBOFPPPPP
PPPPPPBBPPBPBPPPPPFBPPFPPPFBPPPPPPPOPPPPPFPPPPPBPPPPPPPPPPPPPBFPPFPPPOPPPPPPBPPP
PFFPOFPPPPPPBPPBPOPPPPPOPBPPPPPOBPOFPPPPPPPPPBPPPPPPPFPPFOPFPPPPPPPPPFPPPPPPPPPP
PPPBPPPPPPFPPFPPPPPPPPBBPBPPPPPFFPFPOPBPPFBPFPPPPPFPPOPPPBPPPPPPOPPBPPBPFPPFOFPP
PPBPBPPPBPPPPPPBFPOPPBOPPPPPBBOBPPFPPPPPPPPFPPFPPPPPPPPPPFPBPBPPPOFPPBPBPPOPPPPF
PPBPBBFPPPPPPFPPPPPPPPPBPBPPPPPPPPPPPPPPPPBPPPPPOBBPPPOBPPPPFBPFPPPPPOPBPPPPPPPP
BBPOPPPPBPPFBPPPPPPBFPFPPPPPPPPBPPPPPPFPBPPPPBBPOFFBPPFPPPPPPPPPPPPPPPPPPPFFFPPB
PPPBPPPFPPPFPFPFBPPPBBPBPPPPBPPFPPPPPPBPOPBFPPPPBPPPPPPPPOPPPPPPPPPPPFFFPBPPPBPB
PPPPPPPPPOFPPPBBBPBPPPFBPPFPPPPPPPPPFPPPPPBPPPPPPBPPPBPFBPPFBBPPPPFPPPFFPPPPPFFP
PPPPPFPPPPBPPPOPPPPPPOPPFPPPPFPPPPPPPPBPPBPPPPBBFFPBFFPPPPPPPPBPPBPPPPBBPPPPPPPP
OPPPBFPOBPPPPPPPBPPFPBPBPBPPPPPPBPPPOPPPPPPPPPPPPPPPPPBPPPBPBBPPPOPPPOPPPPPPPPPP
PPPPPPFBPFPPOPPPPPBBPPPPFPPPFPPPFPBFBPPPPBOPPPPPPPBPFPPFPFPBBBPPPPPPBPPPPPFPPPBP
PFOBFFFFPPPPPFPPPPFPPOPPPPOPBPOBPPPPPPPOPPPPPPPPBPPPPPOPPPPBPPPPPPPBPPPPOPFFFPPP
PFPBBPPPPFPBPPPPPPPPPPFPFBPPPPPPPFPPPPBPPPPFPPFFPPPPPPPPPFBPFPPPPBBBFBFPBPPPPPPP
PPBFPPPPPPPPPBPBBPBPPPBBPPPPBPPBPOPPPFPPPBPBBPPPPPPFPPBPPPFPPPPPPOPFOPPPPBPPPPPP
BFPBPBPPPPPBPPPPPBFPPPPFPBPPPPPPPFPPPPPPBBBPPBPFPOPPBPPBPBPPPPPPBBPPPPPBPPPBPPFF
PPPPBPPFPPFPPPBPBPPBPPPBPPBPPPOPPPPPPPFPPPPPPPPPPPPPPPPPBPPPPPPPPBPPPFPPFPBFPPPP
PPPPFPBBBPOPPPPPPPBPBPBPBPPOFPPPPPPPPBPPPPPPPPPPPBPFPPPPOPBBPPBBPPPFPPPPPPFPPBPB
PFBPPPFPPPPFOBPPPPPPPPFPPPPPPFPBPPBBBPPPPBFPPPPFPPPPFPPFPBPOFPPPPPPPFBPPPPPPPPFP
PFPPPPPPFPPBPPPFPFBFPPPPPPPBPPPPBPBPPPFPPPPBOPBPBBPPPPPPFFPPPPBPPBPPPBPFPBPPPBPP
PPPPPPBPPPBPPPPPFPFPPPPPPPPPPPPBFPPPPPFPPPPFPPPPPPBPBFPOBPOOPPBFBPPBOPPPFBPPPBPP
PBPBPPOPPPPPPPPBBPFPPPPBPPPPPBBPPBBFPPPPFPPPPPPPPFFPPBPPBPFPFPBPPPPPPPPPPPPPBBPF
PPPPPPBPPPFPPBBPBPFPPBPPPPPPPFPBPPBPPBPPPPPPBBBPPBPPPPBPPPPFPPPPPPPFPPPPPFPPPPPP
PPFPPPPPPFPPPPPBPBPPPPFPPPBBFPPPBPPPPPPPPPPPPPPPPBFPPBPPBPFPFPPPPPPPPPPPBPPOBOPP
PPFPPPBPPPPPPPPPOPPPPPFPPPPFPPBPBPPBPPPPBPFBPBPBFBFPBPFBPOPPPPPPPBOPPPPPPPPPPPPP
PBBPPPPPPPPPBPPOPBBFBOFFPPBPBPBBPBBPPPBPPPPOPPBOBPPBPPFPFPPPBFPPPPPPPPP*******PP
PPBPPPPPPPPFPOPPPBOOBPPBPPPPPBPPPPPPPPFPBPPBPBPBFPBPPPPPPBPPBOPPPPFPPPPP*******P
FBPPPPPPPOPPPFFPPPBPPFPBPPPFPPPPBOBFPPFPBBPPFPPPPBPPPPPPPPPPPPPPPBPPBBPPPPPPP**P
PPBPPPPPPPFBPPFPPBPPPPPPPPPPPPPPPPPPPPPPFPPFPPPPBOPBPPPBPFPBPPPPBPBPPPPPPPPPPPPP
PPPPOPPOPPPPPPPPPPPPPP*******PPPP****PPPPPPPPPPFPPPOPPPPPFOPPPPFPPPPPPPPPPPPPPPP
OPPPPFPPDPPPPPPPPPOPPPP***********PP*PPPPDPPFPPPPPPOPPPPPPPPPPPPPPPPPPFPPPPPPPPP
PPPPPPPPPPOPPPPPPPPOPPPPPPPPPPPPPP****PPPFPPFPPPPFPPPFPPPPPPPPPOPPPPPPPPPPPPPPPP
PPPPPPPPPPFPPPPPDPPPPPPPPPPPPPPPPPPPP**PPPPPPPPPPPPPPPPPPPPFPPPPPPPPPPPPPPPPPPPP
PPPPPPPPPFPPPPPPPDPPOPPPPPPPPPPPPPPPPP*PPPPPPPPPPPOPPPFPPPDPOPPPPPFPPPOPPPFPPPPP
PPPPFPPPPPPPPPDPPPPFPPPPPPPPPPPPPP*****PPPPPPPOPPPPPPPPPPPPPPPPPPPOPPPPPPPPDPPFP
FPPPPPPPPOPPPPOPPPPPPPPPPP*******PPPPPPPPPPPPPPPPPPPPOPPPPDPPPPPPPPPPPPPPOPFPPPP
FPPPPPPPPPPDPPPPPPPPPPPPPPP*******PPPPPFPFFPFPPPOPPPPPPPPFPPOPPPPPDFPPPPPPDPPPPO
PPPPPPPPPPDPDPOPFPPPPPPPPPPPPPPP**PPPPPPPPPPPPFPPPFPPPPPPPPFPPPPPOPDPPPPPDPOPOPP
PPPOPPPPPPPPPOPPFPPPPPPPPPPPPPPPP*PPPPPPPFPPPPPFPPPPPFFFPPPPPPPPOPPPPFPPPPPPPPPP
PPDPPPFPPFPPPPPPFPPPPPPOPPPPPPPPP*PPPPPPPPPPPPPPPPPPPPPPPFPPPPPPPPPPPPPPPPPPFPPP
PPPPPPFPPPPPPPPPFPPPPPPOPPPPPPPPP*PPPFPPPPPPPPPPPFPPPFPPPPPFPOPPPPPFPPPPPPPPPPPP
PPPPPFPPOPPPPPPPPPPPFPPPPP********PPPPPPPFPFPPPPDDPFPPFPPDPOFFPPDFPPPPPPPPPDPPPP
PFPPPPPPPPPPPPPPPPPPDDPPPPP*******PPFPPPPPFFFPPPPPPPPPPPPPPPPPPPPPFPPPPDPPOPPFPP
PPPFPPOPPPPPPPDPPPPPPPFPDPPPPPPPPPPPPDPDFPPPDPPPPPFPPPPPFPPOPDPPPFFPFPPPPPPPPPPP
PPPFPPPPPPPOPPOPPPPFPPPPPPPPPPPPPPPPPPDOPPPPPPPPPPOPPOPPPPPPPPPPPPPFPPOPPPPPPPFP
PFFPPPPPOPPPPPPPPPPPPPFPPPPPFPPPPPPPPPFFPPPPFFPPPPPPPDPPPPFPPDPPFFPPPPPPPPPPPPFP
PPPPPPOFPPPDPPFPPFPDPFPPPPPPPPPFOPDPPPPPPPPPPPOPPPPFPPPPPPPFPPPPPPPPOPPPPPPPPPFP
PPPPPPPFPPPPFPPPPPPPPPPPPPPPPPPPPFPPPPPFFPFPPPPFPPPPPPPPPPPPPPOFPPPPPPPPDPDPPPPF
PPPOPPPPPPPPPPPPPDPFPPPPPPPPPPPDFPPPPPPFPPPPPPPFPPPPFPPPPPPPOPFPPPFPPPPFPPOPPPPF
FPPFPFPPPFPPPPPPPPPPPFPPPPPPPPPPPPPPPPPPPPPFPPODPPPPPPPPPPPPPPPPOPPPFPPPPPPPPFPP
PPFPPPFFPPFDFPPFFPPPPPPPPPPPPPPPPDPPPFPPFPPPPPPPPPPPPFPPPPPPPPFPPPPPPPDPPPPPPPPP
DPPPPPFPPPPDPOPPPPPPPPPPPFPPOPPPPOPFPPPOPPPPPPPPPPPPPPPPPFPPFPPPPPPPOPPPPPPPPPPP
PPPDPPPPPPPPOPPFPPPPPPPPPPPPPPPFPFOPPPOFPPPFPPPFPPPPPPPPOPFPPFPPPOPPPPPPPPPPPPOP
PPPPPPPPPPPPPOPPPOPPFPPPPPPDPPPPPOPDPPFPPPPPPPPPPPPPPPDPPPPPPPPPPPPPPPPPPPPPPPPP
PPPFPPPPPPPPPPPPPPPPPPPPPPPPFPPPPPPPPPPPPPPPFFPPFPPPOPPPPPPPPPPPPPPPPFFPPPPPPOPF
PFPPPOPFPPPPPPPPPFPFPPPPPPPDPPPPPPPPPDDPPPPPFPPPFPFPPPDPPPPPPPPPPPPDPPOPPFDPPFPP
PPOPPPPPPPDPPPPPFPPPPPPPPPFPPPPPFPPPPPPPPPPPPPPPPPFOPDPPPPPPFPOFPPPFPFPPPFPFPPPP
PPPPDPPOPPPPPPPOFPFFPPPOPPPPPPDPPPPPPPPFPPFFPPDPPPPPPPPPPPPPPPPPPPPPPFPPPPPPFPPF
PPDOPPPPPPPPPPPPPPPPPPPDPPPPPPPPPPPPPFPPPPPPPPPFPFOPPPPPPPFDPDPPPPPPPPPPPPPPPPPF
PPOPPPPPPPPPPPFDPPFPPPFPPPPPPPOPFPPPPPPPPPPPPFPPPPPPPPPPPPPPPPPPPPPPPPPPPPPFPPPP
PFPPPFFPPPPPPPPPODPPPPOPPPPPPPPFFPPPPPPPPPPPPDPPPPPDPPFPPPDPPDPPPFPPOPPPPPPPPPPP
PPPPPPPOPPOPFPPPPFFPPPPPPPPPDPFPPPPPPPPPOPPPDPPPFPPDPPPOPPPPPPDPPPPPPFPPPPPPPPPP
PPPPOPPPPPPPPPOFPPPPOPPPPPPDPPPPPPPPPPPPPDPPPPPPPPFPFDFPPPPPPPPPPDPPPPPPFFFPPPPP
PPFPPPPPFFPDPPPPPDPPPFPPPPPPPPPPPOPFPPPPPPPPPPPPPPOFPPPPPPPPPPPPPPPPPPPPPPPPPPPP
PPPPPPPPPPPPFPPPPPPFPPOPPPPPFPPPPPOPPPPFPFPPPPPPPPPFPPPDPPPPPPPPPPPPPPPPPPPPPPPP
PPPPFFPPFPPPPDPPFPPPPPPPPPPPPPFPPFPPPPPPPPPPPPPPFPPPDPPPPPPPPOPPPPFPPPPPPPPPPPPP
PPPPPPPPPPPPPPPPPPPPPFPFPPPPPPPPPPPPFPPFPPFDPPPPPPPPPPPPPFPPPPPPPPPPFPFPFPDPPPPP
PPPPPPPPPPPPPPOPPPPFPPPPPPPPFPPPPFPFPPPPPPPFPPPFPPPPPFPDPPOPDPPPPPPFPPPPPOPPPPPP
PPPFPPPPPPPPPPPPPPPPPPPPPPPPPPPPPPPPPPPPPPPPPPPPPPPPPPPPPOPPPPPOPFPPPPPPPPPPPFPP
PPPPPOPPPPPPPPPPPPPPPPPPPPPPPPOPPPPPPPPPPPPPPPPPPPPPPPDPPPPPPPPPPPPPPPPPPPPOPPPP
PPDPPPPPPPPPPPPPPPPPPOPPPPPPPPPPPPPPDPPPPRPPPPPPPPOPPPPPPPPPPPPPPPPPOPPPPPPPPPPP
DPPPPPPPPPPPPPPPPPPPPPPPPPPOPPPPPPPPPPPPPPPPPPDPPPPPPPPPPPPPPPPPPPPPPPPPPPPPPRPP
PPPPPPPPPPPPPPPPORPPPPPPPPPPPPPDPPRPPPPPPPPPPPPPPPDPOPPOPOPPPPPDPPPPPPPPPPPPPPPP
PPPPPPPPPPPPPPOPPPPPPPPPPPPPPOPPPPPOPPPPPPOPPDPPPPPPPPPPPPPOPPPPPPPPPPPPPPPPPPPP
PPPPPPPPPPPPPPPRPRPPPPPPPPPPPPPDOPPPRPPPPPPPPPPPPPPDPPPPPPPPPPPPPPPPPPPPPPPPPPPP
PPPPPPPPPPPPPPPPPPPPPPPDPPPPPPPPOPPPPPPPPPPPPPPOPPPPPPPPPPPPPOPOPDPPPPPPPPPRPOPP
PODPPPPPPDPPPPPPPPPPPPPPPPPPPPPPPPPPPPPPPPPPPPOPPPPPPPPPPPPPPPOPPPPPPPPPPPPPPPPP
PPPPPPPPPPPPPPPPPPPPPPPDPOPPPPPRPPPPPPPPPOPPPOPPPPPPPPDPPPPPPPPPPPPRPRPPPPPPPPPP
PPRPPPPPPDPPPPPPPPPPOPPPPPPPPPPPPPOPPPPPPPPRPPPOPPPPPPOPPPPPPPPPPPPPPPPPPPPPPPPP
PPPPPPPPPPPPPOPPPPPPDPPPPPDPPPPPPPPPPPPPPPORPPOPPPPPPPPORPPPPPPPPPOPPPPPPPPPPPDP
PPPPPPPPPPOPPPPPDPPPPPPPPPPPPPPPPPPRPPPPPPPOPPPPPPPPPPPPPPPPPPPPPPPRPPPPPPPPPPPR
PPPPPPPPPPPPPPPPPPPPPPPPPPPPPPPPPDPPPPPPPPPPPPPPDPPPPPPPOPRPPPPPPPPPPPPPPPPPPPPP
PPPPPOPPPPPPPPPPPDOPPPOPPPPPPPPPPPPPPPDPPPPPPPPPPPPPPPPPPPDPPPPPPPPPPPDPPPOPPPDP
PPPPPPPPPPPPPPPPPPPDPPPPPPPPPPPPPPPPPPPPPPPPPPPPPPPPPPPPOPPPOPPPPPPPDPPPPPPPPPPP
PPPPPPPPPPPPPPPPPPPDPPPDPPPPPPPPDPPPPOPPPPPPPPPPPPPPPPPPDPPPPPPPPPPPPPPPPPPOPPPP
PPPPOPPDPRPPPPPPPPPPPPPPPPPPPPPPDPPPPPPPPDPPPPPPPPPPPPPPPPPPPPPPPPOPPOPPPPPPPPPP
PPPPPPPPPPPPPPPOPOPPPPPPPPPPPPPRPPPPPPPPPPPPPPPPPPPPPPPOPPRDPPPPPPPPPPPPPOPPPPPP
PPPOPPPPPPPPPPPPPPPPPPPPPPPPPOPPPPPPPPPDPPPPPPPPOPPDOPPPPPPOPPPPDPPPPPPPPPOPPPPP
PPPPPPPPPPPPDPPPPPPPPPPPPPPPPPPPPPPPOPPPPPPPPDPPPDDPPPPPPPPPPPPPOPPPPPPPPPDPPPPP
PPPPOPPPPPPPDPPPPPPDPPPPPPPPPPPPPPPPPPPPPPPPPPPPPPPPPPPPPPPPPPPPPPPRPDPPOPPPPPPP
PPPPPPPDPPPPDOPPPOPPPPPPPPOPPPPPPPPPPPPPOPPPPPPPPPPPPPDPPPPPPOPPPPPDPPPDPPPPPPPP
PPPPPPPPRPPDPPPPPPPPPPPDPPPPPPPPPPPPPOPPPPPPPPPPPPPDPPPPPPPPPPPPPPPPPPPPPPPPPPDP
PPPPPOPPPPPPPPPPOPPPPPPPPPPPPRPPPPPPPPPOPPPPPPPPPPPPPPPPPPPOPPPPPPPPPPPPPPPPOPPR
PPPPPPPPPPOPPPPPPPPPPPPPPPPPPPPPPPPPPPPPPPPPPOPPPPPPPPPPPPPPPDPPPPPPPPPPPDPPPPPP
PPPPPPPPPPPPPPPPPPPPPPPPPPPPPPPPPPPPPPPPPPPPPPPPPDPPPPPDPPPPPPDPPPPPPPPPPPPPPPPP
DPPPPPPPPPPOPPPPPPDPPPPDPPPPPPPPPPPPPPPPPPPPPPPPOPPPPPPPPPPPPDPPPOPPPDPPPPPPPPPP
PPPPPPPPPPPPPPPPPPPPPDPPPPOPPPPPPPPPPPPPPPPPPPPPPPOPPPPPPPPPPPPPPPPPPPPPPPPPPPPP
PPPPPPPPPPPPPPOPPPPOPPPPPPPOPPPDPPPPPPDPPPPPPPPPPPODPPPPPPPPPPPPPPPPPPPPPPPPPPPP
PPPDPPDPPPPPPPPPPPPPPPPPPPPPPPPPPPPPPPPDPPPPPPPPPPPPPPPPDPPPOPPPPPPPPPPPPPPPPPPP
PPPPDPPPPPPPPPPP*******PPPPPPPPPPPPPPPPPPPPPPPPPPPPPPPPPPPPPPPPPPPPPDPDPPPPPPPPP
PPPPPPPPPPPPPODPP*******PPDPPPPPPPPPPPPPPPPPPPPPPPPPPPPPPPPPPPPPPPPPPPPPPPPPPPPP
PPPPPPPRPPPPPPPPPPPPPP**PPPPPPPPPPPPPPPPPPPPPPPPPPOPPPPPPPPPPPPPPPPPPPPPPPPPPPPP
PPDPPPPPPPPPPPPPPPPPPPPPPPPPPPPPOOPPPDPODPPPPPORPPPPPPPPPPPPPP*******PPPPPPPDPPP
PPPPPPPPPPPPPPPPPPPPPPPPPOPPPPPPPPDPPPPPPPPPPPPPPPPPPPRPPPPPPPP*******PPPPPPPPPP
PPPPPPPPPDPDPPPPPPPPPPPPPPPPPPPPOPPPPPPPPPPPPPPPPPPPPOPPPOPPPPPPPPPP**PPPPPPPPPP
PPPPPPDPPPPPPPPPPPPPPPPPPOPPPPPPPPPPPPPPPPPPPPPPPPPPPPPPPRPPPPPPPPPPP*PPPPPPPPPP
PPPPPPPPPPPPPPPPPPPPPPPPPPPPPPPPPDPPPPOPPOPPPPPPPPPPPPPPDPPPPPPPPPPPP*PPPPPPPPPP
PPPPP*******PPPP****PPPPPPPPPPOPPPPPPPPPPPPPPPPPOPPPPPPPPPPPPPPPPPPPP*PPPPPPPPPP
PPPPPP***********PP*PPPPPPPPPPPPPPPPPPPPP*PPPPPPPPPPPPRPPPPPPP********PPPPPPPDPP
PPPPPPPPPPPPPPPPP****PP*******PPPP****PPPP*PPPPPPPPPPPPPPPPPPPP*******PPPPPPPPPP
PPPPPPPPPPPPPPPPPPPP**PP***********PP*PPPP*PPPDPPPPPPPPPPPPPPPPPPPPPPPPPPPPPPPPP
PPOPPPPPPPPPPPPPPPPPP*PPPPPPPPPPPPP****PPPPPPPPPPPPPPPPOPPPPPPOPPPDPPPPPPPPPPPPO
PPPPPPP***************PPPPPPPPPPPPPPPP**PPPPPPPRPPPPPOPPPPPPPPPPPDPPPPPPPPPPPPPP
PPPPPPPPPPPPPPPPPPPPPPPPPPPPPPPPPPPPPPP*PPPDPPOPPPPPPPPPPPPPPPPPPPPPPPPPPPPPPPPP
PPPPPPPPPPPPPPPPPPPPPPPPP***************PPPPPPPPPPRRPPPPPPPPPPPPPOPPPPPPPPPPPOPP
PPPPPPPPPPPPOPPPPPPPPPPPPPPPPPPPPPPPPPPPPPPPPPPPPPOPPPPPPPPDPPPPPPPPPPPPDPPPPPPP
PPPPPPPPOPDPPPOPPPPPPPPPPPPPPPPPPPPPPPPPPPPPDPPPPPPPPDDPPPPPPPPPPPPPPPPPPPPPPPPP
$$$$$$$$$$$$$$$$$$$$$$$$$$$$$$$$$$$$$$$$$$$$$$$$$$$$$$$$$$$$$$$$$$$$$$$$$$$$$$$$
