%%%%%%%%%%%%%%%%%%%%%%%%%%%%%%%%%%%%%%%%%%%%%%%%%%%%%%%%%%%%%%%%%%%%%%%%%%%%%%%%

        %%%%%%%%%%%%%%%%%%%%%%%%%%%%%%%%%%%%%%%%%%%%%%%%%%%%%%%%%%%%%%%%%%%%%%%%%%%%%%%%

        %%%%%%%%%%%%%%%%%%%%%%%%%%%%%%%%%%%%%%%%%%%%%%%%%%%%%%%%%%%%%%%%%%%%%%%%%%%%%%%%

        %%%%%%%%%%%%%%%%%%%%%%%%%%%%%%%%%%%%%%%%%%%%%%%%%%%%%%%%%%%%%%%%%%%%%%%%%%%%%%%%

        %%%%%%%%%%%%%%%%%%%%%%%%%%%%%%%%%%%%%%%%%%%%%%%%%%%%%%%%%%%%%%%%%%%%%%%%%%%%%%%%
################################################################################
################################################################################
PPPPPPBPPBPPPPBPPPPPPPBBPPPPPPBBPPPPPPPBPPPPPPPPPPPPPPPPPPPPPPPPPPPPPPPPBBPPPPPP
PPPPPBBPPPBPPPPPPPPBBPPPPPPPPPPPBPPBPPPPPBBPPPPPPBPPPPPPBPPPPPPPPBPPPPPPPPPPPPPP
PPPPPPPBPPPPPPPPPPPPPPPPPPBPPPPBPPPPPPPPPPPPBPPPPBPPPPPPPPPPPPPPPPPPPPPPPPPPBPBP
PPPPBPPPBPPPPPBBPPPPPBPPBPPPPPBPPPPPPPPBPPPPPPPPPPPPPPPPPPBPPPPPBPPBPPPPPPPPPPPP
PPPBPBPPPPBPPPPPPPPPPBPPPPBPPPPPPPPBPPPPPPPPPBPPPPPPPPBPPPPPBPPPPPPPPPPPPPPPPPBP
PBBPPPPPPPPPPPPPPPPPPPPPPPPPBPPPPPPPPBPPPBPPPPPPPPBPPPPPPPPPPPBPPPPPPPPPPPPPPPPP
PPPPPBPPBPPPPPPPPPBPPPBPPPPPPBPPPPPPPPPPPPPBPPPPPPPPBPBPPPPPPPPBPPPPPPPPPBPPPPPP
PPPPPPPPPPPPPPPPPPPPPPPPPBPPPPPPPPPPPPBBPPPPPPPPPPPPPPPPPPPPPPPPPPPPBPPBPPPPBPBP
PPPPPPPPPPPBPPPPPPPPPBPPPPPPPPBPPPBPPPPPPPPPPPPPPBBPPPPPPBPPBPPPPPBPPPPPPPBPPPPP
PPPPPPPPPPPPPPPPPBBPBPPPPPPPPPPPPPPPPBPBPPPPPPPPPPPPPPPPPBPPPPPPPPPPPPPPPPPPPBPP
PPPPBPPPPPBPPPPPPPPBPBBPPPPPPPPPPPBPPPPPPPPBBPPPPBPPPPPPPPBPBPBPPPPPPPPBPBPPBPPP
BPPPPPPPPPBPPPPPPPPPPPPPPPPPPPPPPBBPPPPPBPPPPPBBPPPPPPPPPPPPPPPPPPPPPPPPPBPPPPBP
PPBPPPPPBPPPPPPPPBPBPPPPPPPPPPBBPPPPBPPPPPPPPPPPPBPPPPPPBPBPPPPBPPPPPPBPPPPBPPBP
BPPBBBPPPPPPPBPPPPPPPPBPPPBPPPPPBPBPBPPPPPPPPPPPPPPPPPBPPPPPPPBPPPPPPPPPBPPPBPPP
PPPPPPPBPPPPPPPPPPPPBPPBPPPPPPPBPPPPPPPPPBPPPBPPPPPPPBPPPPPBPPPPPPPPPPPPPBPPPBPP
PPPBPPPPPPPPBPPBPPPPPBPPPPPBPPPPPPPBPPPPPPPPPPPPBBPPPPPPPPPPPPPBPBPPBPPPPBPPPPPP
BBPPPPPPPPPPPPPPBBBPBPPPPPPPPPPPPPPPPPPPPPPPPPPPPPPPPPBBPPPPPPBPBPPPPPPPBPPPPPPP
PPPPPPPPPPPPPPPPPPPBPPPPPPPPPPBPPPBPBBPPPPPPBPPPPPPPPPPPBPPPPPBPBPPPPPPPPBPPBPPP
PPBPPPPPPPPPPPPPPPPPBPPPPPPPBPPBPBBBPPPPPPPBPPBBPPPPPPPPBPPBBBBBPPPPPPPPPPPPPPPP
BFPPPFPFPPPPPPBOPPBPPPPFPBPPPPBBPBPBPFPPPBPPPBPOOPPPPPPOPPPPPPPPFPPPPBPPPFBPPPPP
PBPPPPPPBPPPBPPFBBPPPBBPPPPBPPPPPBPPPPPPPPBPBPPBPFPPFPPBBBPPOPPOPPBPPPPPPFPPBBPP
PBBPBPFPPPPBBPPBPPPPPBPFPPPFPPPPPPPPBFPPBBPBPPPPPPBFPPPPPBFBPPOPFFPPPPPPPBPFBPPP
PPOPPPPBPPOPPOBPPPPPPPBPPPPBPPPPPPBPFFOPPBPPBPPPPPBPBPPPBPPPFPPPBPPBFPPPBFPPPPPF
PPPPPFPBPPBPPPPFPPPBPPPBBFPBPBPBBBPPPPPPPPPFFPPPPPPPBPBPPFPPFPOPPPPPPPPPOPPPFPFP
OPPBPPPPPPPPOBPPOPBPPPFPPPPPPPPPBFPPPPBPPPPPFBPFPPOPPPBPBPPPPPBBPPPBPOPPPBPBPPPP
PPPBPBPPPPPPPPPPPPBBPPPPPPPPPFPPPPPPBBBPBBPPPBPPFPPBFFPPPBPBBPPPPPPPPPFPFPPPPPPP
PFPFPPPPPPPPBPPBPFFPPPBPPPPPPPPBPPBPPPPOPBFPFBFBPPOPPBPPPBPPFPBPPPPPPPPPPPPPPFPP
PBOFOPPPPPPPPBPPBBPPFPPPPOBPPPPPPFPPPBPBPPPPPFBPPPPPPPPBPBFBPPPPPPPPPBPPPPBPPPPP
PBPPPPPPOBPFPPPBOPBPPOFBPPPFPPFOOPBOFPPPPPPPPPPPPPPPPPPOBPPPBPPPPPFFPPPOPPPPPPPP
FPPPPFPPPPPPBFPOPOPFBPPFPBFPPPBPFPPPOPPPPPPPPPPBPPPPPFPPPBPOPPPPPPPBPPFPPPPPFPPP
PPPBFPPPPPFBPOPPBFPBPBPBBFPPPPPBPPPPPPPPPPFPPPFPBPBPPOPPBPPPPPPPPPPPBPBPPPOPBPBP
PPPBPPPPPPPPFPPBPPPPPPPPPPPPPPOPPPPBPPPPPPPPPPPPPBPPBPPPPOPPPPPPPPBPPBPPPFBPFPOP
PBPPPPOPFPPPPPOPBPPPPPPPBPPBBPFPBPBPPPPPOPPPPPPPPPPOPPBPBPOPPFPPPPPBBBPPPPBPPFPF
PFPPBFPPPPBPPPPPPPPPPPPPBFPBPPFPPPPPPPBPPBPPPBPPPPBPPBPPPPBPPPPPPPPPPBBPFPBPBPPB
PPPBBPPPPPPPPBFBPFPBPPPBPPBPPFOPBPPBPPOPBPPPPPPPPPPPPBPBPBPOBBPPPPFPFPBPPPPPPOPP
BOPPPPPFPBFBBPPPPPBPFPOBPPBPPPPBPFPPPBPPFPPPBPBPPPPPPPBPPPPPPPPPBPPPBPPPPPPFPPPP
PPFPPPPPPFPBPBPPFPPPBPFPPPPPPPPPPPPBPPPPPPBPPBPOPPBPPPPPPPPFFPPBPFPBPPPPFPPPPPPO
PPPPPPPPBPPPBPPFPPPPBPFPPPOPPBPPPFPPBBBPPBPPPBFPPPBPPPPPPPPPPPPPPPPOPPBBPPPPPPPP
PPPFBPPFBPBPBPPPPPPBPPPPOPPPPPPPPPBPBPPBPPPFPOPPPPBPPPPPPPPBPPPOPPFPBPPPFPPPP***
PPPPPBPPBPPPPOPPPBPPPPPPPPPPPPPPPFPPPPPBPFPPBOBPPPFPPPPPPPPPBPPBPOPPPPBPPPPBPP**
FPFBPPPPPFPPPPBBPPBPPBBBPPPPBFPPPPPPPFPPPPPPPFBBPBPPPPPPPPOPPPFPPPPPBPPFPPPBPPPP
PPPPPBPPPPBPPPPPPPPPPPPPPBPBPPFBPPBPBPPBPPOPPPOOPPPPBPPBPPPPPOPPPPPPOPPPBPBPPPPP
PPPOPPPBFPFPPOPPPPPPPPPPPPBFBPPPOBFBPPPPPPPBBPPPPPPPPPPPPPPFBPPOBPPPOPPPPPPPPPPP
FPBPPPPPPPPPOFPPPFPPPPPPPPBBPPPPPPPBPBFPPPPPPPBPPPPBPPPPPPPPPPPPPBPPPPPFPBPPPPPP
BPFPPPPOPPPPPPPPPPPPFPBPBPPPPPPFFPPBPPPPPPBPPPBPPPPPPPOPPPPPPPBPPPPPPBPPPPFPP***
POPPPPPPBPPPOPBPOBPPPPPPPPBPPPPPPPPPBPPPPPPPBPBBPPPPPPPPPPBPPFPBBFBFPPPPBFPPPP**
FPPPPPPPFPPPPPPPBBPPBBPPPPPBPPFPPPPFPFFPPPFPPFPPBPPPPPPPPBPBBPPBBOOPPFPPBPOPPPPP
PPBBPPPPPPPPFPPBPOPPPPBPPPBPPPPPPBFPFBPPPPPPBPBPPPPPOPPPPPPPBPPBPPPPPBPPPPPBPPPP
PPOPPPPPBPPPPPPPBOPPPPPPBBPPPBPPPPPPPPFPBPPPPFPPPPPPFPPBOPPPPPPBPPPPFPPPPPBPFPPP
PPPPOPPPPPPPOPPDPPPPPPPFPDPPPPFPPFPPPPPPPPPPPPPPPPPPPDPPPPPPPPPPPPPPPPPPPPPPFFPF
PPPPPFPPPPPPPPPPPPPFPFPPFPPPPPPPPDPPPPDPPPPPPPPPPOPPPPPPPPPPFPFPOPPFPPPPPFPPPPPF
PFPPFPPFPPPPPPFPOPPPPPPPPPPPPPPPPPPPPPPPPPPOPPPPFPPPFPOPFOPOPPPPPPPPPPPPPPPPPFPP
PPPPPOPPPPPPPPPPPPPPPPPPFPOPPPPPPPPPOPPPFPPPPPPPPPPPPPDOPPPPPPPPPPPOPPPPPPPFPPPO
PPPPPFPPPPPPPPPPOFPPPPFPPPPPPPPPPPPPPPPPPPPPPPPPPPPPPFPPPPPFPPPPPPPPPPPPOPPPPPPP
PPPPPPPPOPPPPPPDPPPPFPPPPPFPPPPPPPPFPPPFPPFPPPOPPPPPPPPPPPPDPPPPPOPPPPPPPOPPPPFO
PPPPPPPPPPPPPFPPPPPPPPFPPPPOPPPPPPPPDPPPPPPPPPPPPPPPDPPPPPPDPPDFPPDPPPPPPPPPPPPP
PPPPPPPPPOPOPPPPPPPPPPPPFPPPPPPPPPFPPPPPDPPPPPPPFPPFPOPOPPPPFPPPPPDPPPOPPFPFPPPP
DPFPFPPPPPPDPPPFPPDPPFPDPPPPPFFPPPPFPPPPDPPPOPPPPPPPPPPPPPPPOPPDPPOPFPPPDPPPFPPF
PPOPPPPDPFPPFPPPDPPFPPPPPPPPPPPDDPFPPPDFPPOPPPPPPFPPPPPPPPPPDPPPPPPPPPPOPPPPPPPP
PPFPPPPPPPFPPPPPPPPPPFPPPPFPPPPPPPPPPPPPPPPPPPPPPPPPPPPPPPPPPPPPPPOFPFPPPPPPPFPP
FPFPPPPPPPPPPPDPPPPPPPPOOPFPPPOPPPPPPPPPPPPOPPPDPFPPPPPPPPPPPFPPFPPPPOPPPPPPPPPO
DPPPPFPPPPPPPPPPPPPFPPPPFFDPPPPPPPPPPPPPPPPPPPPPPPPPPPPPPPPPPPPPPPPPPPPPPPPPPFPP
PDPPFPPPFPPPPFPFPPPPPPPFPPPFPPPPPPPPPPPPPPPDPPPPPPPPPPPOPPPPPPPPPPFPPPPPPPPPPPPP
PPPPPPOPOPPPPPPPPPPPPPPPPPPPPPPPPPPPPPPPPPPPOPPPPPPDPPPPOPDPPPPPPOPPPPPPFPPPPOPP
PPPPPPPPPPPOPPPPPPPPPOOPPPPPPPPPPPPPPPPFPPPPPPPPPPPPPPPPFPPPPPPPPPPPPPPPPPPPFFOP
POPPPPPPPPPPPPPPPPPDPDPPPPPPPPPPPPPPPPPPPOPPPPPPPPPPFPPPPFPPPPPPPPPPPPFPPPPPPPPP
PPOPPPPPPPPPPPPPFPPOFPPPPPPPPFPFPPPPPOPPDFPOPPPFPPPPPPPPFPPPPFPPPPPPPPPPPPOPPPPP
PDFPPFPPDPPPPPPPFPPPPPPPPFPPPPFPPPFFPPPPPPOPDPPPPPFODPPPPPPPFFPPPPPPPPFPPPPPPPPP
PPPPPPPPPPPPPPPPPPFFPPPOPFPFPPPPPPPFPPFPPPPPPOPPPPOPPPPPPPPPFPPPPPPPPPPPPPDPPPPF
PPPPPFPPPPPPPPPPPPPPPPPPPPPPPPPPPPPFPPPDPPFFPPPPPPPFFPPPPFPPOPPPPPPDPFFPPPPPOPFF
PPPPFPPPPPPPPPPPPPPPPPPPPPPPPPPPPFPPPPPPPPPPPPPPPPDFPPPPPPPPPFPFOPPPFPPPPFPPPPOP
PPPPFPPPPPFPPPPPPPPPPPPPPPPPPPPPPPPPPPPPFPPPPFPPPPPPPPPPPPFPPPPPPFPFPPPPPPFPPPPP
PPPPPPPPPOPPPFPPPPPPPP*******PPPP****PPPPPPPPPPPPPOPPPPFPPPPPPPPDPFPPPPPPPFPFPPP
FPPPPPPPPPPDDPPPPPPPFPP***********PP*PPPPPFDPPPPPPPDPDPPPPPPOPPPFPPPPPPPOOPPPOPP
PPPPPOPPPPPPPPPPPDPPPPPPPPPPPPPPPP****PPPPPPPPPDPPPPPPPPPFPPOPPOFPPPPPFPPPPPPPPP
PPFFPPPPPFPPOPPFPFPPPPPPPPPPPPPPPPPPP**PPPPPPPPPPPPOPPPPPPPPPPPPPPPPPPPFDPPPPPDP
PPPFPOPPPPPOPPPPPPFPPPPPPPPPPPPPPPPPPP*PPPPPPPPPFPPPPPPPPPPOPPPPPPPPPPPPPPPPPPPO
FPOPPPPPPPPPPPPPFPPPPPPP***************PPPPPPPPPPPPPPPDFPPPPPPPDPPPPPPPPPFPPPPPP
PPPPPPPOPPPFPPPPPPPPOPPPPPPPPPPPPPPPPPPPPPPPPPFPPPPPPPFPPPPPOPPOPPFDPOFPPPPPPPPP
PPPPPPPPPPPPPPPFPPPPPPPPPPPPPFPPPPPPPPPPFPPFPPPPPPPPPPPPPPPPOPOPPPPPPPPPPPPPPPPP
PPPPPFPPPPPPPPPPPPPFPPPPPPPPPPPPOPPPPPPPPPPFPPPPPOPPPPPFOPPPPPPPPPPFPPPPPPPPPPPP
PPPPPPPFPPPPPPPPPPPOPPPPPPPFPPPPPPPPPPFPPPPPPPPPPPPPOPPPPPPPPPFPPPPFPPPDFPPPPPPP
FPPPPOPFPPPPPFPPPFPPPPPFPFPPFPPPPPPFPPPPPPPPDFPPPPPPPPPPPFPPPPOPPPPPPPPPPPPPPPPP
PPPPPPFPOPPFPPPPPPPPPPPDPOPOFPFPPPPOPPPFFPPPPPPPOPPPPPPPPPPPDPPPPPPPOPPPPPPFPPPP
PPPPFPPPPPPPPPPDPPPPPFPPFPPPPPPPPPPPPPDPPPOPPPOOPPFPPPPPPPPPPPFPPPPPPPDPPPPFPPPF
POOPPPPPPPPFFOPPPPPOFPPPOPDPDPFFFPPPPPPPFPPPPOPPPPFPPPPPPPPFPPPPDPPPPPPPPPPPPPDP
FPFPPPPPPPPPPPPPPPPPPFPPPPPPPPOPOPOPPPPPPPPPPPFFPPPPPPPPPPPPPPPPPPPPPPPPPPPPPOPP
PPDPPPFPPPPFPFFPPFPPDPFPFPPOPFPPPFOPPPPPPPPPPPDPFFPPPPPPOPPPPPPPPPPDPDPOPPOPPFPP
PPFOPPPPPPPPOPPDPPPPPPPPPPPPPOPPPPPPPPPPPPPPPPPPFPPPPPPPFPPPPPPFPPOPPOPPDPPPPPFP
PPPPPPPPPPPPPPPPPPPPPPPDPPPPPPPPPPPPPPPPPPPPPPPPPPPPPPPPDOOPPPPPOPOPPPPPPPPOPPPP
PPPPPPPPPPPPPPPPPPPPPPPPPOPPPPPPPPPPPPPPPPOPDPPPOPDPPPPOPPPPDPPPPPPPPPPPPPPOPPRP
PPPPPPPPPPPPPDPPPPPPPDPPPPPPPPPPPPPPPPRPPPPPPPPPPPPRPPPPPPPPPPPPPPPPPPPPPPPPPPPP
PPPPPPDPPPPPPRPPPPPPPPOPPPPDPPPPPPPPPPPPPPPPPPPPPPOPPPPRPPPPPPPPPPPPPPPPOPPPPPPP
PPPDPPPPDPPOPPPPPPPPPPPPPPPPPPPPPPPPPPPPPPPPPPPPPPPPPPPOPPPOPPPPPPPPPPPPPPPPPPPP
PPPPPPPPPPPPPOPDPPPPPPPPOPPPPPPPPPPPPPPPROPPPPPPDPPPOPPPOPPPPPPPRPPPPPPPPPPPOPPP
PPOPPPPPPPPPPPPPPPPDDPPPPPPPPPPPPPPPPPPPPPPPPPPPPPPPPPPOPPPPPPPPPPPPPPRPPPPPPPPP
PPPPOPPPPPPPOPPPPPPPPPPPPPPPPPPPPPPPPPPPPPPPOPPPPPPPPPPPPOPPPPDPPPPPPPPPDPPPPPPP
PPPPPPPPPPPPPPPPPPPPPPPPPPPPPPPPPPPDPOPPPPPPPPPPPOPDPPPPPPPPPPDPPPOPPPOPPDPPPPPP
PPPDPPPDPPPPPPPPPPOPPPPPPPPPPPPPPPPPPPPPPOPRPPPODPPPPPPOPPPPPOPPPPPPPPPPPPPPPPPP
PPPOPPPPPPPPPPPPPPPPPPPPPPPOPPPPPPPPPPPPPPPPPPPPPPPPPPPPDPRPPPPPPPPPPPPPPPPPPDPP
PPPPPPPPPPPPPPPPPOPPPPPPPPPPPPPPPPPPPPPPPPPPPPPPPPPPOPPPPPPPPPPPPPPRPPPPPPPPPPPP
PPDPPPPOPPPPPPPPPPPPPPPRDPPPPPPOPPPPPPPPPPPPPPPPOPPPPPPPPPPPPPPPPPPPPPPPOPOPPPPP
PPPPPPPPOPPOPPPPPPPPPPPPPPPPPPPPPPPPPPPPPPPPPPOPPPPPPPOPPDPPPPPPPPPPPPPOPPPPPPPP
PPPPDPPPPPPPPPPPPPPPPPPPPOPPPOPOPPOPPPPPPPPOPPPPPPOPPPPPPDPPPPPPPPPPPPPPPPPPPPPP
PPPPPPPPOPPPPPPPPOPPPPPPPPPPPPPPPPPPPPOOPPPPPPPPPPPPPPPPPPPDPPOPPOPPPPPPPPPPPPPP
PPPPPPPPPPPPPPPPPPPPPPOPPPPPPPPPOPPPPPPPPPPPOPPPPPPPPPPPPPPPPPPPPPPPPPPPPPPPPPPP
PPPPPPPPPPPPPPPPPPPPRPPPPPPPPPPPPPPPPPPPPPPPPPPPOPPPPOOOPPOPPPPDPDPPPOOPPPPPPPPP
PDPPPPPPPPPPOPRDPPPPPPPPPPPPPPDPPPPPPPDPPPPPPPPPPPPPOPPPPPPPPPOPPPPPPPOPPPPPPPPP
PPPPPPPPPPPPPPPPPPPPPPPPPPPPPPPDPPPPPOPPPPPPPPPPPPPPPOPPPPPPPPPOPPPPPOPPPPPPPPOR
PPDPPPPOPOPPPPPPPPPPPPPRPPPPPPPPPPPPPPPPPPPRPPPPOOPPPPPPPPPPPPOPPPPPPPPPPPPPPPPP
PPPPPPPPPPPPPPPPPPPPPPPPPPPPPPPPPPPPPPPPPPPPPPPPPPPPPPPPPPPPPPPPDPPPPRPPPPOPPPPP
PPPPPPPOPPPPPPPPPPPPPPOPPPPPPPPPPPOPPPPPPPPDDDPDPPPPPPOPPPPPPPPPPPOPPPPPPPDPPOPP
POPPPPPPPPPPPPPPPPPPPPPDPPPPPPPPDDPPPPPPPPPPPPPPPPPPPPPPPPPPPPPPPPPPPPPPPPOPPPPP
PPOPPPPPPPPPPPPPPDPPPPPPPPPPPPPPPPPPPPPPPPPPPPPPPPPPPDPOPPPPPPPPPPPPPPPPPPPOPPPP
PPPPPPPPPPPPPPPPPPPPPPPPOPPPPPPPPPOPPPRPPRPPPPPPPPPPPPPPPPOPPPPPPPPPPPDPPPPPPPPP
PPPPPPPPPPPPPPPPPPPPPPPPPPPPPPPPPPPPPPPPPPPPPPPPPPPPPPPOPPPPPPPPPDPPRPPPPPPPPPPP
PPPPPPPPPPPPPPPPPPPPPPPPPPPPPPPPPPPPPPPPPPPPPPPPOPPPPPPOPPPPPDPPPPPPOPPPPPPPPPDP
PPPPPPPOPPPPPPPPPPPPPPPPPPPPPPPPPPPPPPPPPPPPPPPPPPPPPPPPPPPDPPPPPPPPPPPPPPPPPPPP
DPPPPPPPPPPPPDPPPPPPDPPPPPPPPPPPPPPPPPPPPPPPPRPPPPPPPPOPPPPPPPPPPPPPPPRPPPPPPPPP
PPPPPPPPDPPPPPPPPPPPPPPPPPPPPPPPPPOPPPPPPPPPPPPPPPPPRPRPPPPPPPOPPPPPPPPPPPPPPPPP
PPPPRPPPPPPPPPPPPPPPPPPPPDPPPPPPPPPPPPPPOPPPPPPPPPPPPPPPPPPPPPPPPPPPPPPPPPPPPPPP
PPPPPPPPPPPPPPPPPPPPPPPPPPPOPPPPPPPPPPPPPPPPPPPPPDDPPPPPPPPPPPPPPPPPDPPPPPPOPPPP
PPPPPPPOPPPPPPPPPPPPPPPPPPPPPPPPPPPPPPPPPPPPPPPPPPPPPPDPPPPPPPPPDPPPPPPPPPPPPPPP
PPPPPPOPPPPPPPPPPPPPDPPPPPPOPPPPPPPPPPPPOPPPPPPPOPPPPPPPPPPPPPPPPPOPPPPPPPPPPPPP
PPPPPPPPPPPPPPPPPPRPPPPPPPPPPPPPPPPPPPPPPPPPPDPPDPOPPRPPPPPPOPPPPPPPPPPPPDOPPPPP
POPPPPPPPPPPPOPPPPPPPPPPPPPPPPPPPPPPPPPPPPPPPPPPPOPPPPPPPPOPPPPPPPPPPPPPPPPPPPPD
OPPPPPPPDPPPPPOPPPPPPPPPPPPPPPPDPPDPPPPPPPPPPPPOPPPPPPPPPDPPPPPPPPRPPPPPDPPPPPPP
PPPPPPPPPPPPPPPPPOPOPPPPPPPPPPPPPPPPPPPPPPPPPPPDPPPPPPPPPPPPDPPPPPPPPPPPPPPPPPRP
PPPPPOPPDPPPPPPPPPPPPPPPPPPPPPPPPPPPPPPPPPPPPPOPPPPPPPPPPRPPPPPOPPRPPPPPPPPPPPPP
PPPPPPPPPPPPPPPPPPPPPPPPPPPPPPPPPPPPPPPPDPPPPPPPPPPPPPPPPDPPPODPPPPPPPPOPPPPPPPR
PPPPPPPPPPPPOPPOPPPPPPPPPPPP*******PPPPPPPPPPPPPPPPPPPPPPOPPPPPPPPPPPPPDPPPPPOOP
PPPPPPPOPPOPPPPPDPPPPPPPPPPPP*******POPPPPPPPPPPPPPPPPPPPPPDPPPPPPPPPPPPRPPPPPPP
POPPPPPPPPPPPPPPPPPPPPPPDPPPPPPPPP**POPPPPPPPPDPPPPPPPPPPPPPPPPOPPPPPPPPPPPPPPPP
PPPPPPPPPPPPRPPRPPPDPPPPPOPPPPPPPPP*PPOPPPPPPPPPPPPPPPPPPPPPPPPPPPPPPPPPPPPPPRPP
OPPPPPDPOPPPPPPOPPPPPPPPPPPPPPPPPPP*PPPOPPPPPPPPPOPPPPPPPPPPPPPPRPDPPPPPPPPPPPPP
PPPPPPPPPPPPPPPPPPPPPPPPPPPPPPPPPPP*PPPPPPPOPPDPPPPPPPPPPPOPPPDPDPPPPPPPPPPOPPPP
PPPPOPPPPPPPOOPPPPOPPPPPPPPP********PPPPPPPPPPPPPPRPPPPPPPPPPPDPPPPPOPDPPPPPPPPP
$$$$$$$$$$$$$$$$$$$$$$$$$$$$$$$$$$$$$$$$$$$$$$$$$$$$$$$$$$$$$$$$$$$$$$$$$$$$$$$$
