%%%%%%%%%%%%%%%%%%%%%%%%%%%%%%%%%%%%%%%%%%%%%%%%%%%%%%%%%%%%%%%%%%%%%%%%%%%%%%%%

        %%%%%%%%%%%%%%%%%%%%%%%%%%%%%%%%%%%%%%%%%%%%%%%%%%%%%%%%%%%%%%%%%%%%%%%%%%%%%%%%

        %%%%%%%%%%%%%%%%%%%%%%%%%%%%%%%%%%%%%%%%%%%%%%%%%%%%%%%%%%%%%%%%%%%%%%%%%%%%%%%%

        %%%%%%%%%%%%%%%%%%%%%%%%%%%%%%%%%%%%%%%%%%%%%%%%%%%%%%%%%%%%%%%%%%%%%%%%%%%%%%%%

        %%%%%%%%%%%%%%%%%%%%%%%%%%%%%%%%%%%%%%%%%%%%%%%%%%%%%%%%%%%%%%%%%%%%%%%%%%%%%%%%
################################################################################
################################################################################
PPPPPPPPPPPPPPPPPPPPPPPPPBPPBPPPBPPPPPPPPPBPPPPPPPPBBPPPPPPPPBPPPPPPPPPPPBPPPPPB
PPPPPPPPPPPPBPPPPPPBPPPPPBPPPBPPPPPPPPPPPBPPPBPBPPPPBPBPPPPPPPBBBPBPPPPPPBPPPPPB
PPPPPPPPPPPPPPPPPPPPPPPPPPPPBBPPPPPPPPBPPPPBPPPPPPBPPPPPPPPPPPPPPPPPPBPPPPPPBPPP
BPBPBPPPPPPPPPBPPPPPPPPPPPPPPPPBPPPPBPPPPPPPBPPPBPPPPPPPPPPBPPPPPPPPPPPBPPPPPPPP
PPPPPPPPPPPPPPPPPPPBPPPPPPPPPPPPBPPPPPPPPPPPPPPPBPPPPPPPBPPPBPPPPPPPPPPPPPPPPBPP
PPBPPPPPPBPPPPPPBBPPPPPPPPPPPPPBPPPPBPPPBPPPBPPBPPPPPPPPPPPBPPPPBPPPPPPPPPBPBPPP
PPPPBPBPPPBPPPPBBBPPPBPPPPPPPPPPPPPPPPPPPPBPPBPPPBPPPPPPPPPPPPPPPBPPPPPPPPBPPPPP
PPPPPPPPPPPPPPPPPPPPPPBPPPBPPPPPPPPPPPPBPBPPPPPPBPPPBPPPPPPPBPPPPPPPBBBPPBPPPPBP
PPPPPPBPPPPBPBPPPPBPPPPBPPPPPPPPPPPPBPPPPPPPPPPPPPPPPPPPPBBPPPPPPPPPPPPPPBPPBPPP
BBPPPBPBPPPPBPBPPPPPPBPPPBPPPPPPPPPPPPPPPBPPBPPPPPBPPPPPPPPPPPPPPBPPPPPPPPPPPPPP
PPPPPPPPPPPBPPBPPPPBPBPBPPPPPBPPPPBPPPPPPPBPPPPPPPPPPPBPPPPPPBPPPPPPPBBPPPPPPBPP
BPPBPPBPPPBPPPBPPPPPPPPPBPPPPPPPPPPPPPBPPPPPPPPBBPPPPPBPPBPPPPPPPPPPPBPPPPPPPPPP
PPPPPPPPPPPPPPPPPPPPBPPPBPPPPPPPPPPPPPBPPPPBPPPPBPPPPPBPPPPBPPPPPPPPPPPPBPPPPPPP
PPPPBPBPBPPBPPPPPPPPPPBPPPPPPPPPPPPPPPPPPPPPBPPPPPPPPBPPPPPPPPBBPPPPPPPPPPPBBBPP
PPPPPBPPPBPPPPBPPPPPPBPPPPBPPPPPPPPBBPPPPPPPPPBPPPPPPPPPPPPBPPBPPPPPPPPPPPPPPPPP
PPPPPPBPPBPPPPPPPPPPPPPPPPPPPPBPPPBPPPBPPBPPBPPPPPPPPPPPPPPPPPPPPPPPPPPBPPPPPPPP
PPPPPPPPPBPPPPPPPBBPPPPPPPPPPPPPPPPPPPPPPPBPPPPPPPPPPPPPBPPPBBPPPPPBPPPPPPPBPPPP
PPPPPBPPPPBPPPPPBPPPPPPPPPPPPPPPPBPPBPPPPPPPPPPPPPPPPPPPPPPPBPPPPPPPPPPPPPPBBPPP
BPPPBPPPPBPBPPPPPBPBPPPPPPPPPPPPPBBPPPPPBPPPPPPPPPPPPPPPPPPPPPPPPPPPPBPPPPPBBPPP
PPPFPPBPPPPOPPPPPPPPPPPBPPBFPPFPPOFPBPBPPPPPOFPPBPPPPPOPPBPPFPPFPPOPBBPPPBPBFPPP
FPPPBPPBBBPPPPPPPPPPPPPPPFFPFPPPPBFPPPPFPPPPPPPPBPPPPPPBPPPPOPPBPBPPPPOPPOPOPPBB
PPOPOPFPPPPPPPPBPPBBPPBBPBPFPPFPPPPPBBPPBOPPPPPPPPOPBPBPPPPPPPPPOPPPPPBPPPPPBPPP
PPFPBPPPPPPBPPPPPOFPPBPPPPPFPFOPPPPPPPPOPPPPPPFBPPOPPFBPPPPPPBPPPPBBPPFPPPPBPPPB
PPPPBPBPPOPPPPPBPPPPPPPPPPBPBPBPPPBPPFPBPOPBPPBPFPPPPPPPPFPBPBPPPPPPPPPBFPPPPBBB
PPPOPPPPPBFPPPPBPPBBBBPBPFPBPPPPBPPBPPPPPPPPPBPPPBPPPFBPPFPPBPBBPPFBBPPPPPFFPBBP
PPPPPPPPPPPBBPBPPPPBPPPBPPPPBOPPFPPPPPPPPPBPPPPPPOPFPPPPPPPPPPPPPBPPPBBBBPPPPPPP
PPPFFBPPPFPBFFPBPPPPBPPPPBPPPPPPPPPFPPPPPPPPBPPPPPFPPPBFPBBOPPBBPPPPFFOPPPOPPPPP
PPPFBPPPPPBPPBPPPPPPPPOPPPFPPPPPPPPPFPPOPPPPPPBPPPFPFPPPPPFOPBPPPOPPBPFPPOPPPPPP
PFBPPPPPPPOPFBPFBPPPPPPPBFBFPPPBPPPPPPPBFPPPPOPPPPOPOPPPPBPPPBPBPPBPPOPBPBPPFOFP
PFPFPBBPBPPPFPPPPPPPPPPPPPPPPPPPPPPPBBPBPPPPPFPPPPPPBOPPPPPPPBPPFPPPBPOPPFPBBPPP
PPPBPBBPPPFOPPP*******PPPP****PPPPPFBPPPPBPPPPPPPPPBPPFFPPPPPPBPFPBPBPPPPPPPPFPB
BPFPPBOPPPFBPPPP***********PP*PPPPPBOPPPPPFPPBFPPOPPPPPPBFPPPBPPPFPFPBPPBPPPPPPF
PBPPPPPPPPPPPPPPPPPPPPPPPPP****PPPPFPPPPPOBBFBPBPBPPPPBPBPPPPPPPPPBPPPPFPPPOPPPB
PBFPPFPPPBBPPOPPPPPPPPPPPPPPPP**PPPFBPPPPPPPPPPPPPPPPPPPPPPPPPPFPPPPPPBOPPFPPPPP
PPBBFPPPPPFPBBPPPPPPPPPPPPPPPPP*PPPPPPPBFPPPPBPPFFPPPPPPPPPPPPOPPPOPPPFPPPPPBFBP
PPBPPBPPPPPPPPPPP***************PPPPBPPPPPBFBPPPBPPPPBBPPPPPPPFPPPBPPPPPPPPPBPPP
PPPPPBPPPPPPBPPPPPPPPPPPPPPPPPPPPPPPPPBFPPPBPOBPPPBPPBPPOPPOPPPPPPPPPPFFPPPPPPPB
PPPPPBPPBPPPPBPBPPPPPPPPPPPPPPPFPFPBPPPPPFPPPPOPPPBPBPPBPPBPPPPPPPPPPPPPPPPPPPPP
PPPPPPPBPFPPPOPPPPPPPPPPBPBPBPPPBPBPOPFPPPOPPFPFBPPPBPPPBBPPPPPPOPPPBPBPPPPFBPPP
OOPBPFPPPPPPPFPFPPPPPFBPPPPOPPPBPPBBPPFFPFPPFBPPBPPBPPBPPPBPPFPPBOPPPPFPPOPBPPPP
PPPPPPPPPBPPPBPPFPPPPPPBPPPPBPPPPPOPPPPBPPPFPFPPBOPPPPPPPBPPBFBFPPOFBPOFFPPBFBPP
FPPPPBPPPBPPPPBPPPPPPPPPPPPPPBPFPPOPFPFBPOPPPPBPPPOBPPFPBPPBPPPPPOPPPPPPFPPPPPPP
PPPPPPPPBFPPPFPFPBPOPPPPBPPPPPPBPPPPPBPBOPPBPPOPPPPPPPPPBPPPPPPPBPBPBOFPFPPPBPFP
BBPFFPPPFPPFPPOPFPPPPPBPPPPBPBPBPPPPPPPPFOPPPPPPBPPPPPBPPBPPPPPPPPOPPBPPPPPPBPPF
OPPPPPPPBPPPPPPPPPBPPPPPFPPFFFPPPPPPPBPPOPBBPPPPPPPPPPPPPPBPBPPPFPBPPPPFPPBPPFPP
BPPPPPPFPPPBPPBPPPOPPPPPPFPOPPPPPPBPPPPPPPPPPPBBPPPPPPFPPFPBBPPPBPPPPBBPBPOFPPPP
PBPPBPPPBPPPBPPPPPPPPPPFPPPPBPPFPPPOBPPPPPPBBPPPPPPBPPPPPPPOPFPPPPPBOPPPPPBPPPFO
PPBBPPPPBBFPPPBBOPBPPPBPPPPBPPPPBPPPPPPPFPPPPBPFOFPPPPPPPBPPPPBPPPPBFPOPPPPPPPPP
BPBOPPPPPPPPPPBPBPPBBPPPOPPPPFFBPPPPPPPPFPPBPPBPPPPPPFBPPFFPPPPPPFPPFFPPPOPPPPOP
PPPPPPPPPPPPPPPPPPPPPPPPPPPPPPPPPPPPPPPPPPPPPPPFFPOPPPPPPPFPOPPPPPPPPPPPPFPPPPPD
POPPPPOPPPPPPPPPPPPFPFPPPPPPPPFPPPPPPFPOFPPPPPPPPPPPPPPPFPPPPPPPPPPPPPPDPPPPPPPP
PPPPPPPPPPFPOPPFPPPPPPPPPPPPFPPPPPPPPPDPPDPPPPPPPPPPPPPPPPPDPPDPPPPPPFPPPPPPPFPP
PPPPPPFPPPPPFPPPPPPPFPPPPPPPPPPOPPPPPPPPPFPPPPPFPPPPPPPPPPPPOPPPPPPPPPFFPPFPPPPP
PPPFPPPPFDFFPPPPPPPPPPPPPPPFPPPFPDPPPPPPPPPPPPPPPPPPPPPPPPPPPPPPPPOPPPPPPDPPPFPP
PPPPPPPOOPPPPFPPPPDPPPPPPPPPPPPPPPPPPPPPODPPPPPPPPPPPFPPPPPPDFPOPPPFPPPFPPPPPPFP
PPPPPPPPPFOPPPPPPPPPPPDPPPPPPPPPPPPPPPPPPPFPPPPDPOPPPPPPFPPPOPPPPPPPPPPPPPPPPPPP
DFFPPPPPPPPPPPPPPPPPPPPPPPPPPPPPPPPPFPPPPPFPPPPFPPPPPPPPPPFPPPPPPFPPPPPPPPFPPPPP
PPPPPPOOFPPFFPDPP*******PPPPPPFPPPPPPPDPPPPPPFFPPFPPPFPPPPPPFPFPPPPPPPPPPPPPPPPP
PPFPFPPDPPPPPPPPPP*******PPPPPPPPPPPPPPPPFPPPDPOPPPPPOOPPFPPPPPPFPPOPPPPPPPFPPPP
PPPPFPPFPOOPPPFFPPPPPPP**PPPPPPPPPDPFPPOPPOPPPPPPPPPPPFPPDPPFPPPPPPPPPPOPPPPPPPP
PPPPPPPPPPPPPPPPPPPPPPPP*PPPPOPPPPPPPPPPPPPPPPPPPPPFPPFPPPPPPPPPPPPPOPPDPPFDPPPP
PPP*******PPPP****PPPPPP*PFOPPPPPPPFPPOFPPPDPFPPPPPPPPPFPPPFPOPPPPPPPPPPPPPPPPOP
PPPP***********PP*PPPPPP*PPPOPPPPOPPDPPPPPPPPPPPPPPPPPPPPPPPPPPPFPPPPDPPPPPFPPPP
PPPPPPPPPPPPPPP****PPP***PPPFPPPPPPPFPPPPP*******PPPP****PPPPPPPPPPPOOPPFPPPPPFP
PPPPPPPPPPPPPPPPPP**PP***PPPPPPFPPPPPDPPFPP***********PP*PPPPPPPPPPPPPPFPPPPPPPP
PPPPPPPPPPPPPPPPPPP*PPPPPPPPPFPPPPPPPPFPPPPPPPPPPPPPPP****PPPPPPPPPPPPPPOPPPPPPP
PPPPP***************PPPPPPPPPPPPPPFFPPPOPPPPPPPPPPPPPPPPP**PPPFPPFPPPDPDPPPPPFPP
OPPPPPPPPPPPPPPPPPPPPPPPPPPPPPPPFPPPPPPPPPPPPPPPPPPPPPPPPP*PPPPDPPPPPPPPPPPFPPPP
PPPPPPFPPOPPPPPFPPPPPPFFPPPPPPFPPPPPPPPDDPPP***************PPPFPPPPPPFPPPFPPDPPP
FPPPPPPPPPPPPPPPPPOPPPPPPPPPPPPPPPPPPPPPPPPPPPPPPPPPPPPPPPPPPPPPPPPPPPPPPPPFPFPP
PPPPFPPPPPPPPPODPPPPPPFPPFPPPPPPPPPPPDPPPPPPPFPPFFFPPPPPPPPPPFPPPPPPPPFPPPFPPPPP
PPPDPDPPPPPOPPFPPPPPPPDPOPPPPPPPPPPPPPPPPPPPPPPPPPPPFPFPPOPPPPDPPPPPPPPFPPPPPPPF
PFPPPPPPPPFFPPPPPPDPPPPPPPPPPPPFDPPPPPPPPFPPPPPPPPPPPOPPPPPPPPPPPPPFPPPPDPPPOFPP
PPPPPPPPPPPPPPPOODPPPPFPPPPPPPPPPPPPPPPPPPFPDPPPPFPPPDPPPPPPPPFPOPPPPPPPPPPPPPPP
PPDPOPPPPPPPPPPDPDPPPFPPPOPPFPPPOPPFDPOPPPPFFPPPPPOPPPPPPPPDPPPPPPPOPPPPPPPPPPPP
PPPPPPPPPPFPPPPPPPFOPPPPPPPFPPDPPFPPPPPPPPPPFPPPPOPPPFPPPPOPPPPPPPPFFPPFFPPPOPPP
PPPPOPPFPPPPPPPPFPPPFPPPPPPPPPPPPFPP*******PPPPOPPPPFPPPPPPPOPOPPDPPFPPPPPPDPFPP
PPPPPPPPPPPPOPPPPPPPFPPPPPPPPPOPPPFPP*******PFPOOPPPPPPPPPPPPPFPPPPPPPOPPPPPPPPP
PPPPFPPPPPOPPPPPPPPPPPPPPPPPPPPPPFPPPPPPPP**PPPPFPPPDPPPPPPPPOPPPPPPPPPPOPPPFPPO
PPPPPPPDOPPPPPPPFPPPPPPPPPPFPPPOPPPPPPPPPPP*PPOFPPPPPPPPPFFPPPPPPPFPPPPPPPPPPDPP
PPPPPPPPFPPPPPPPPPPFPPPPPPPOPPPFPFPPPPPPPPP*PPPPOPPPDPPOPPOPFPPPPPPPPPPFPPPOFODP
PPOOPPPPPPPPPPPPPPFPPFPPFPPPPPPPPPPPPPPPPPP*PPOPPPPPPPPPPPPPPFPPPPPPPPPPPPPPPPFD
PPPFPPPPPPPFPPPPPPPOPPPPPPDPPPPFPDPP********PPPPFPFPFPPPPPPFPPPPPPPPPPFPFPPPDPPP
PPPPPPFPDPPPPPPPPPPPFPPPPPPPPPPPPPPPP*******PPPPPPPOPPDPPPFPPFPPPPPPPFPPPFOPFPPP
PPPPPPPPPPPPOPPPFPPPFDFPPPPPPPPPFPPPPPPPPPPPPPPPPPOPPPPPPPPPPPPPPPPPPPPPPPPPPPPP
PPPPPPPPPFPPPDPPPFPPPPPPPFPOPPPPPPPPPPFPFPPOPPPPPPPPPPPPOP*******PPPP****PPPPPPP
PDFPPPPPPPPPPOOPPPPPPPPPPPPPPPPPPPPPPDPPPPPPPPPPPPPPFPPPPPP***********PP*PPPPPPP
PPPFPPPPPOPPPPPPPDOPPPFOPPPPPPPPPPPPPPPDDPPPFPPFPFPPPPPOOPPPPPPPPPPPPP****PPPPPP
OPPPPPPFPFPPDPPPPPPPPPFOPPFFDPPPPPPPDPPPPPFPPPPPPPPPPPFPPPPPPPPPPPPPPPPPP**PPPFP
OPPPPPPPOPPPPPPPPPPPPPPPDPPPPPPPPRPPPPPPPPPPPPPPPPPPPPPPPPPPPPPPPPPPPPPPPP*PPPPP
PPPPPOPPPPPDPPPPPPPPPPPPPPPPPPPPPPPPPPPPPPPPPPPPPPPPPPPPPPPP***************PPPPP
PPPOPPPPPPOPPPPPPPOPPPPPPPPPPPPPPPPPPPPPPPPRPPPPPPPPPPPPPPPPPPPPPPPPPPPPPPPPPPPP
PPPPPPPPPPPDPPPPOPPPPPPPPPOPPPPPPPPPPPPPPPPOPPPPPPPOPDPRPPDPPPPPPPPPPPPPPPPPPPPP
PPRPPPPPPPPPPPPPPPPPPPPOPPPPPPPPPPPPPDPPPPPPOPPPPPPPPPPPOPPPPPPPPPPPPPDPPPPPDPPP
PPPDPPPPPPOOPPPPPPPPPPPPOPPPPRPPPPPPPPPPPPPPOPPPPPPPOPPPPPPPPPPPPPPPPPPPPPPPPPPP
DDPPPPPPPPPPPPPPPPPPPPPPPPPPPPPPPPPPPPPPPPOPPPPPPPPOPPPPPPPPOPDPPOOOPP*******PPP
PPPPOPPPPPPPPPPPPPPPP*******PPPPPPOPPPPPPPPPPPPPPPPPOPPPPPPPPPPPPPPPPPP*******PP
DPPPPPPPPPPPPPPPPPPOPP*******PPPPPPPPPPPPPPDPPPPPPPPPDPPPPPPPPPOPPPPPPPPPPPP**PP
PPPPOPPDPPPPPPPPPPOPPPPPPPP**PPPPPPPPPPPPPPOPPPPPPPPPPPPPPPPPPPPPPOPPPPPPPPPP*PP
PPPPPPPPPPDDPPPOPPPPPPPPPPPP*PPPDPPPPPPPPPPPPPPPPPPPPPPPPPPPPPPPPPOPPPPPPPPPP*PP
PPPPPPPPPDOPPPPPPPPPPPPPPPPP*PPPPPPPPOP*******PPPPPPPPPPOPPRPPPPPPPPPPPPPPPPP*PO
PPPPPPPPPPPPPPPPPPPDPPPPPPPP*PPPPRPPPPPP*******PPPPPPPPPPPPPPPPPDPPPPP********PP
PPPPPPPPPPPPPPPPPPPPP********PPPPPPPPPPPPPPPP**PPPPPPPPPPPPPOPPPPPPPPPP*******PO
PPPPPPPPPPPPPPPPPPPPPP*******PPPPPPPPPPPPPPPPP*PPPPPPPPPPPPPPPPPPPPPPPPPPPPPPPPP
PPPPPPOPPPPPPPPPDOPPPPPPPPPPPPPPPRPPPPPPPPPPPPPPPPPPPPP**PPPP****PPPPPDPOPPPPPPP
PPPPPPPPPPPPPPPPOPPPPPPPPPPPPPPPRPPPPPPPPPPPPPP*******PP******PP*PPPPPPPPPPPPPPP
PPPPPPPOPPOPPPPPPPPPPPDPPPPPPPPPPPPOPPP*******PP*******PPPPPPP****PPPPPPPPPOPPPO
POPPPPPPPPPPRP*******PPPPPPPPPPPPPOPPPPP******PPPPPPP**PPPPPPPPPP**PPPPPPPPPPPPP
PPPPPPPPPPPPPPP*******PPPPPPPPPPPPPOPPPPPPPPPPPPPPPPPP*PPPPPPPPPPP*PPPPPPPPPPPPP
PPPPPPPPPDPDPPPPPPPP**PDPPPPPOPPPPPPPPPPPPPPPPPPPPPPPP*P***********PPPPPPPPPPPPP
PPPPPPPPPPPPPPPPPPPPP*PPPPPPPPPPPPPPPPPPPPPPP*******PP*PPPPPPPPPPPPPPPPPPPPPPOPP
PPPPPDPPPPPPPPPPPPPPPPPPPPPPPPPPPPPPPPPPPPPPPP*******P*PPPPPPPPPPPPPPPPPPPPPPPPP
PPPPPPPPPPPRPPPPPPPPPP*******PPPP****PPPPPPPPPPPPPP**P*PPPPPPPPPPPPPDPPPPPPPPPPP
PPPPPPPPPPPPPP*******PP***********PP*PPPPPPPPPPPPPPP*PPPPPPPPPPPPPPPPPPPPPPPPPPP
PPPPPPPPPPOPPPP******PPPPPPPPPPPPP****PPPPPPPPPPPPPP*PPPRPPPPPPPPPPPPOPPPPPPPPPP
PPPPPPDPPPPPPPPPPPPPPPPPPPPPPPPPPPPPP**PPPPPPPPPPPPP*PPOPPPPPPDPPPPPDPPPPPPPPPPP
PPPPPPPPPPPPPPPPPPPPPPPPPPPPPPPPPPPPPP*PPPPPP********POPOPPPPPPPPPPPPPPPPOPDPPPP
PPPPPPPPPPPPPPPPPOOPPPPP***************PPDPPPP*******PPPPPPPPPPPPPDPPPPPPPPPPPPR
PPPRPPPPPPPPPPDOPPPPOPPPPPPPPPPPPPPPPPPPPPPPPPPPPPPPPPPPPPPPPPPPPPPPPPPPPPPPDPPP
PPPPRPDPPPPPPPPPPRPPPPPPPPPPDPPPPPPPPPPPPPPPPOPPPPPPPDPPPPPPPPPOOPPOPPPPPPPPPPPP
PPPPOPPPPPPPPPPPPPPPPPPPPPPPPPPPPPPOPPPPPPPPOPPPPPPPPPPPPPPPOPRPPPPPPPPPPPPPPPPO
PPPPPPPPDPPPPPPPPPPRPPPPPPPDPPPPPPPPPPPPPPPPPPPPPPPPPPPPPOPPPPPPPPPPPPPPPPPOPPPP
PPPPPOPPPPPPRPRPPPPPDPPPPPPPPPPPPPPPPPPPPPPPPPRPPPPPPPPPPRPPPPPPDPPPPPPPPPPPPPPP
PPPPODPPPPPPPPPPPPPPPPPPPPP*******PPPP****PPPPPPPPPPPPPPPPPPPPPPPPPPPDPPPPPPPPPP
DPPPPPPPPRPPOPPPPPPPPPPDPRPP***********PP*PPPPPPPPPPPPPPPOPPOPPDPPPPPPPPPPPPPPPP
PDDPPDPOPPPPPPPPPPPPDPPPPPPPPPPPPPPPPPP****PPPPPPPPPPPPPPPPPPPPPOPDPPPPPPPPPPPPP
PPPPPPPPPPPPPPPPOPPPPPPPPPPPPPPPPPPPPPPPPP**PPPPPPPPPPPPPPPPPPPPPPPPPPPPPPPPPDPP
PPPPPPPPPPPPPPPPPPPPPPPPPOPPPPPPPPPPPPPPPPP*PPPPPPPPPOPPPPPOPPPPPPPPPPPPPPPPPPPP
PPPPPPPPOPOPPPPPPPPPOPPPPPPPP***************PPOPPPPPOPPPPPOPPOPPPPPPPPPPPPPPPPPP
OPPPPPDPPPPDPOPOPPPPOPOPPPPPPPPPPPPPPPPPPPPPPPPPPPPPPDPPPPPPPPPPPPPPPPPPP******P
PPPPPPPPPPPPPPPPPPPPPPPPDPPPPRPPPPPPPPPPPPPPPPPOPPPPPPPPDPPPPPPPP*******PP******
PPPPPPPPPPP*******PPPPPPPPPPPOPPPDPPPPPPPPPPPPPOPPPPPPPPPDPPPOPPPP*******PPPPP**
PPPPPPPPPPPP*******PPPPPPPPPPPPPPPPPPPPPPPPOPPPPPPPPPPPPPPOPPPPPPPPPPPP**PPPPPP*
PPPPPPPPPPPPPPPPP**PPPPPPPPPP*******PPPPPPPOPODPPPPPPPPPPPPPPOPPPPPPPPPP*PPPPPP*
PPPPPPPPPPPPPPPPPPPPPPPPPPOPPP*******PPPPPPPPPPPPPPOPPPPPPPPPRPPPPPPPPPP*PPPPPP*
PPPPPPPPPPPDPPPPPOPPPPPRPPPPPPPPPPP**PPPPPPPPPPPOOPPPDPPPPPPPPOPPPPPPPPP*P******
PPPPPPPDPPPOPPPPPDPPPPPPPPPPPPPPPPPPPPPPPPPPPPPPPOPPPPPPPPPPPOPPP********P******
$$$$$$$$$$$$$$$$$$$$$$$$$$$$$$$$$$$$$$$$$$$$$$$$$$$$$$$$$$$$$$$$$$$$$$$$$$$$$$$$
