%%%%%%%%%%%%%%%%%%%%%%%%%%%%%%%%%%%%%%%%%%%%%%%%%%%%%%%%%%%%%%%%%%%%%%%%%%%%%%%%

        %%%%%%%%%%%%%%%%%%%%%%%%%%%%%%%%%%%%%%%%%%%%%%%%%%%%%%%%%%%%%%%%%%%%%%%%%%%%%%%%

        %%%%%%%%%%%%%%%%%%%%%%%%%%%%%%%%%%%%%%%%%%%%%%%%%%%%%%%%%%%%%%%%%%%%%%%%%%%%%%%%

        %%%%%%%%%%%%%%%%%%%%%%%%%%%%%%%%%%%%%%%%%%%%%%%%%%%%%%%%%%%%%%%%%%%%%%%%%%%%%%%%

        %%%%%%%%%%%%%%%%%%%%%%%%%%%%%%%%%%%%%%%%%%%%%%%%%%%%%%%%%%%%%%%%%%%%%%%%%%%%%%%%
################################################################################
################################################################################
PBPPPPPPPPPPBPPPPPBBPPPPPPPPPPPBPPPPPPPPPPPBPPPPPPPPBPBBPPPPPPPBPPBBPPPPBPPPPPPP
PPPPPPBPBPPPPPPPBBPPPPPPPPPPPPPPPPPPPPPBPBPPPPPPPPPPPPPPBPBPPPPPPPPPPPBPPPBPPPPP
PPPPPPPPPBBPPPPPPPBPPPPPPPBPPPPPPBPPPPPPBPBPPPBBPPPPPPPPPPPPPPPPPBPPPPPPPPPPBPPP
PPPBPPPPPPPBPPPPBPPPPPPPPPPPBPPBPPPPPBPPPPPPPPBPPPPPPPPPPPPPPPPPBPPBPPPPPPPPPPBP
PPPPPPPPPPPPPBPPBPPPPBPPBPPPPPPPPBBPPPPPPPPPPPPBPPPPPPBPPPPPPPPPPPPPPPPPBPPPBPPB
PPPBPPPPPPPPPBPBPPPPPPBPBPPPPPPBPPBPPPPPPPPPPPPPPPPPPPPPBPBPPPPPPPPPBPPBPPPBPPPP
PBPBPPPPPPBPPPPBPPPPPPPPPPPPPPPPPPBPPBPPPPPPPBBPPPBPPPBBPBBPPPPPPBPPPPPPPPPPPPBP
PPPPPPPPPPPPPPPPPPPPPPPPPPBPPPPPBPPPPPPPBBPPBPPPPPPPPPBPPPPPPPPPPBPPPPBPBPPPPPPB
PPBPPPBPPPPPPPPPPPPPPBPPPPPBPPPBPPPPPPPPPBPPPPBPBPPPPBPPPBBPBPPBPPPPPPPPPPBPPPPP
PPPBPPPBPPPPBBPPBPPPPPPBPPPPPPPPPPPPPPPPPPPPPPPPPPBPBPPPPPPPPBBBPPPPPPPPPPPPPBPB
PPPBPBBBPPPBBBPPPPPBBPPPBPPPPBPPPPPPBPPPPPPBBBPPPPPPBBPPPPPPPBPPPPPPPPPPPPPPPBPP
PPPPPPPPPPPPPPPPPPPPBBPPPPPBPPPBPPBPPPPPPPBBPPPBPPPPPPPBPBPPPPPPPBBPPPPPPPPPPPPP
PPPPPPPPPPBPPPPPPPPPPPPPBBBPBPPPPPPPPBPBPPPPPPPPPPBPPPPBPPPPPPPPPPBBPPPPPPPPPPBB
PPPPPPPBPPPPPPPPPPPPPPPPPPBPPPPBPPBPPPPBPPPPPPBPPBPPBPBPPPBPPPPPPBPPPPBBPPPPPPPP
PPPPPPPPPPBPPPPPPPPPPBPBPPPPPPPPPPPPBPPPPPPPPPPPPPPPPPPPBPPPPPPPPPPPPBPBPPBPPPPP
PPPPPPPPPPPPPPPPPPPPPPPPPBPBPPPBPPPPPPPPPPPPPPPPPPBPPPPPPPPPBPBPPPPPPPPPBPPBPPPP
PPPPPPPPPPPPBPPPPPPPBPBBPPPPBPPBPBPBBPBPPPPPPPPPPPBPPPPBPPPPPBPPPPPBPPPPPBBBBPPP
PPPPPPPPPPPPPPPPPPPPPBBPPPPPPPPPBPPPPBBPBPPPPPBPPPPPPPPBPPPPPPPPPPPPPPPPBPPPPPBB
PPPPPBBPPPPPPPPPPPPPPPBPPBPPBPPPPPPPPPPBPPPPBPPBPPPPBPBPPPPPPPPPPPPPPBPPPPPPPPPP
PPPPPBBFPPBPPPPPPBPFPPOPPPPPBPFPBPPPPPPPBPPBBPPPPBBPPPPPPBPPBFOPFPPPPPPPPPPPFPOF
BBPPPPPPBBPPPPFPFBPOBPBBPPPPFFPOPPPPPPOPPFBPFBPPPPPBPFPPPPPPBPPPFPPFBPPPBPPBPPPP
PPPPFPPPPPBPPPFPFPPFPPPFPPPPBOPFFPPPPPPPBOPOPFBPPPPPPPPPPPPPPPPPPPPPBBPPBPPPPBPP
OPPPPPOPPPPPPPPPPPPBFPPOPBPBPPPPPPPPBFBPPPPOPBBBPBPBPPPBPPPPBPPBPPPFBPFPOPBOPPPB
PPPPPFPPPBPOPPPPPPPBBPPPBFPFPPPPPBPFPPBPPPPPFPPPPPFPBPBFPPBPPPPPPPPPFPBOPPBPBBPO
PPPPPBBPPPPPPPPPBPPBOPPOFPPPPPPOPOBOPPPPPPPPBBPBBPPPBPPBPPOBPBPPPPPBPPBPPFPPPPPF
FPBPPPPPPPPPBBPOPPPPFFBPPPPPBBPPPOOPPBPFPPFPPPFPPFPPPPFFPPPBPBBPPBPPPBPFPPBPPFPP
PPPPPPPOPPPBBPBPPPBPPPPFFPPPPPPPBPPPPOPPFPPPPPPPPPPFPBPPPPPBPPPPPOBPPPPPPPPBPPPP
PFBBPPPBPPPPFBPPPPPPPOPPFFPPPPPPPPPPBBPBPPFPOPPBPPPPPBBBPPPBPPPPPBPPPBPBFPPPBPPP
PPBBPPPPFPPPPPPBPPBBPBPBPFBPBOPPPPPPPPPPPPPPBPPPOPPPPPBFPPPPOPPPPBPPPPBPPPPPBPPP
PBPPPPBPPPPBPPPPBFPPPPBBPPBPPPOPBBPBBPPPPPPPPPPPPPPPPPPPFBPPPPPPFPPPPPPPBOOPPPFP
PBPPBPPBBOPPPPPPPBPPFFPPPBPBBOPBBPPPPPPPPBPPPPPBPPPPBPFPPPPPPPPPPPFPFBFBPPPPBPPP
PBOFPPPPPPPPPPPFPOBPPBPPPPPPPPPPPOPPPPFBPPPPPFPPBPPPPPPPBPPFFPOPOPPPPBPPBPPPOPPP
FPPBPPPPPPPPOPBPPPPPPPPPFPPPPPFOPBPBBBPPPPPPPPPPPOFFPPPPBPPPPPPPPPPOOPOPPPPFPPPP
PBOPPPPPPPPPPPPBPPFPPPFPFPPPPPPFPOPPPPPPPPFPFPPPPFBPBPPPPPPPBBPPPBPPPPPPPBOBOPPP
PPPPPPPBPPPPPPPPPFBBPOBPPPPBBPOBPBFBPPPPFPPBPBPPPPPPOPBFPPFPPPPPBPPPPPPPPPPPBPBP
PPPPPBPPPPPPPPPBBPBPPPPBPPPPPOBPPPPPBPPPPPPPBBPPPPPPOPPPFPBOPBPPBPPPPPPFPPPPBPPP
PPBBBFFBPPPPPPBBPPPPFPPPPPPPPPPOPPPPPBPPBPBBPFBPPPPPPPPBFPPBPPPPPPPPPPPPPPBPPPBP
PPPPPBPPOPFFPPPPPFBPPPPPPBBBPPBFPPPBBBPPPBPPPPPPPPPPPPPPPFPBBBFPFPPPBPPBFPPPPPPO
PFPPPPPOPPPFFPBBPBPPBPPPPPFOPBPPPPBFPPPBPOPPPOPBPPPBPPPFPFPPPFFFPBOPPPPPPPFPPPBP
BPPPPPPBPOFPPPPPPPBPPPPFPBPPOOPFPPPPPPFPPPPPPPPBPPBPOPBPPPPPPPPPPPPPBPPPFPPPPFPB
BPPPPPPFOBOPPPBBPPFBOPPPFBPPPOPPPBPBPPBPPPBPPPPPPPPPPPPPPPBP*******PPPPPPBPPPPPP
PPBPPPFPPBPPPPBFPPBPBBPPPFPPBPBPPBPPPOPPFPBBPPPPP*******PPPPP*******PPPBPBBPBPPP
FBPPOPPPBFBFPFPPOPPPPPPPBPFPPPPPBPPPFPPPOPBPBPPPPP*******PPPPPPPPP**PPPPPPPPPPBP
BPOBBPPPPPBBPFBBPPPPPBPBPPPPOPPPPPPFPBPPPBFBBPPBPPPPPPP**PFPPPPPPPPPPPPPBPOPPPPB
PPPPPBPPBFFPBBPBPPOPPPPPBPPPPPOPPBPPPPPBPPPPPPPBPPPPPPPP*PPOPPBBBPPPFPPFPFPBPPPO
PBPPFPPPPBBPPPPPPBPPPFPBBPPPPPPFFPBPPPFPBPPFPPOPPPPPPPPP*PPPOPPPPPPOPPPPPBPPPPPP
PPBPPPPPPPPPBPPFPBBPPPBPPFPPFPBBPBBOPPPPPPPFPPPPPPPPPPPP*PPPBPPPPPPPFBPBPPFPPOBP
PPPPPPPBPBPPPPPBPPPPPPPPBPOPBPPPPPFPPPPPPPPPPPBPP********PPPPPPOPPPPPPPOPPPPPBPP
PPBFPPPFPBPPOPPPPPBPBPPPPBPPPPFFPPPPPPPPBPPFPPPPPP*******PPBPPBPPPPPPFPBFBPPPPPP
PPPDPPFOPPPPPFFPPOPPPPPPPPPPPPPPPPPPPFPPPPDPPPPPPPPPPPPPPPPPPPPPPPPPPPPOPPPPPPPD
PPPPPPPPFPFPPPPPOPPPPPPPPPPFFPPPPPPDPFPPPPPPPPPPPPPPPPPPPPPPPPPPPFPFPPPPPFPPPPPP
PPPFPPPPPPPPOPPPPPFPPPPPPPDPPPPPPPPPPPPPOPPPPFPPPPPPPPPPPOPPPPPPOPPPPPPPPPPFPPPP
FPPPPPPFPPPOPPPPPPPPPPFPPPFPPPPPPPPPPPPPPPFPPPPPPDPPFPPPPPPPPPPPPPFDPPFPPPPPPDFP
PDPFPPPPPPPPPPPPPPPPPPPPPPPPFFPPPPPFPPPPPFPPFPPOPPPDPPPPPPPPPPPPPPPPPPPDPPFPPFPF
PPPPPPPPPPPPPPPPPOPFFPFPPPPPPPDPPPPPFPPDPPPPDPFPPPPPPFPOOPFPPPPPPPPDPPPPPPPPPPFF
PPOPPDFPPFPPPPPPPPPFPPPPPPPPPPPPPPPPPPPPOPPPPPFPPPPPPFPPFPOPPOPPPPFPPPPPPPPPPPPP
PPPPPOPPPOPPFPPPPFPPPPFPPPPPPPPPPPPPPFPPPPPFPPPPPPPPPPPPPPFOPPPPPOPPPPPPPPPPPPFP
PPFPOPPPPPPPFPPDPPPPPPPPFPPPDPPPPPPPPPPPPPPPPPPPPPPPPPPPPPPFPPPPPPPPPPPPPPPPPPPO
FFPPPPFPPPPPPPPPPPFPPPPPPPPPPPPPPPPFPPOPPPPFOPPPPPPFPPPOOPPFFFPPOPPPPFPPFPPPPPPP
PPPPPPPPPPPPPPPOPPPPPPPPPFPPPPPPPPPPPPPPPPPPPPPPPPPFPPPODPFPPPPPPPPPPPFPPPFPPPPP
PPPPPPPPPPPPPFPPPPPPPPPPPPFPPPFPPPPPPPPOPOPPPOPPPOPPPPPPPPDPPPPPPPPPPPFPPPPOFPPP
PPPPPPPPPPPPPPPPPPPPPPPPFFPPPPOPPPPFPPPPPPPPPPPPPPPPFPPPPPPPPPPPPPPPPPPFPPPPPODP
PPPFPPFPPPPPPPPPPPFOPPPPPPPPPPPDPPPPPPPPPOOFFPPPPPDPPPPPPPPFPPPPPPPPPPPPPPPPOPPP
PPPFPPPPPPPPOPPPFPPPPPPPPFPPPDFPPPPPPFPPPPPPFPPPPPPFPPPPPFPPPOPPPPPPPPPPPPPPPPPP
PFPPPPPPPPPPFPPFPPPPPPPPPPPPDPPPPPPPPPPPPPPPPPPPPPFPPPPFPPPPPPPPPPPPPPPPPPPPPPPP
PPPPPPPPFPPPPPPPPPFPPPDPPPPPPPPPPPPPPPPPPPPPPFPPPPPPPPPPFPFPPPPFOPPPPPPPPPPPPPPO
PPPPOFDPPFPPOPOPPPFPPPPPPPPPPPPPDPPPPPPPFPPPPPPDPPPPPPPPPPPPPPPPPPPPPPPPFPPPFPPP
PPPPPPPPDPOOPPPPPPPPPPOPPPPPPPPFPPPPPPPPPPPPFPPPPPPPPPPFPPPPPPPPDPPDPPPPPDPPDPPP
FPPPPPDPPPPPPPPPPPFPDPPOPFDDPPPFPPPPPDPPPFPPPPPFOPPPFPPPFPPPPPFPPPPPPFPPPPPPPPPP
PPPPPPPPPPPPPPPPPPPFPPPPPPPPODPOFPFPPPPFPPPOPFPPFPPPPPPPPOPPPDPOPDPPPPPFOPPPPPPP
FPPFPPPPPPPPPPPFPPPPPPPODPPPPPPDPPPOPPPPPPPPPFPOFPPPPPPOPPFPPPPOPOPPPPPPPPPPPPPP
PPPPDPFFFDPPPPFPPPPPPPPPPPPPPFPPPPPPPPPPPPFPPPPPFPPOPPPPPPPPPPPPPPPPPPPPPPPPPPPP
PPPPPPPPPPPPPPPPPPPFPPPPPPPPPPPPPPPPPPPPPPFPPPFPPPPPPPPPPPPPFPPPFPPPPPPPPPPPFPPP
PPPOPPPPPPPFPFPPFPPOPPFPPPPPPPPPPPFPPPPPPPPPPPPPFPPPPPPPPPPPFFPPPPPPPPPPPDPPFOPF
PPPPFFPPPPPPPPPPPPPPPPPPPPPPPDPPPPPPPPPPPPPPPOPPOPPPPPPPPPPOPPPPPPPPPPPPFPPPPPPP
OPPPPPPPPPPPPPFOPFPPPPDFPPPPPPPPPFPPPDPPPPPPFPPPPPPPPPPPPPDPDPPPPPPPPFFPFPPPPPPP
PPPPPPPPFPPPPPPPPPPPPPPPPPPPPPOFPPPPFPPPPPPPPPPPPPPPPPPOPPPPPPPPPPPPFPPPPPPPPPPP
PPPPDFPPPPPPPPPPPPPPPPPOPOPPPPPPPOPPPPPPPPPPPPPPPPPPPPPDPPP*******PPPPPPFPPDPPPP
PPPPPPPPPPFPPPFPPPFPPPPPPPPPPPPPPPPFPPOOPPPPPPDPPPPPPPPPPPPP*******PPPPDPPPPFPPP
PPPPPPDPPPPPPPDPPPPFPFPFPPPPPPPPPFPPPPPPPPPPPPPPPPOFPPPPPPPPPPPPP**PPPPPPPPPPPPP
FPPPPPPPPPPPPPPOPPPFPPPPPFPPPPPFPPPPFPFPPPPFPPPPPPPFPPOPPPPPPPPPPP*PPPPPFPPPPPFP
PPPPPPPPPPPPPPPPPPPPPPPOPPPPPPPPOPPPPFPPPPOOPPPFPPPPPPPPPPPPPPPPPP*PPPPPPOFPPPPF
PPPPPOPPPPPPPPPPPPPPPPPPDPPPPPPPPPPPPFPOFPPPPPPFPPPPPPOPPPPPPPPPPP*PPPPPPPPFPPPP
DOPPPPFPPPPPPPPFPFPPPPPPPPFPPPFFPPPPPPDPPFPPPPPPPPPPDPPPDPP********PPPPPPPPPPPPP
PPDPPPPPPPPPPPPPFPPPPPPPPOPPFPPPPPPPFPFPPPPPPPPPFPFPPPPPFPPP*******PPPFPPPOPPPPO
PPPFPOPDPPPPPPPPPPPPPPPPPPPPPPFPFPPPPPPPPPOPPPPOOPPPPPPPPPPPPPPPPPPPPFPPPFPPPFPO
FPPPPPPPPPPPPPPPPPPPDPPPPPPPPPPPPPPOPPPDFPPPPOPPPPPPPPPPPPPDPPPPPPPPPPPOFPPPPPPP
PPPPOPPPPPPPFPPPPPDPPPPPDPPFPFPPPPFPPPPPPFPPPPDFPPPPDPPFFFFPPPPPPOPPFPPPPPPPPPPP
PPPFPPPPPPPPPPPPPPPPPPPPPPOPPPPDPPPPDPPPPPPPPDFPPPPDPPPPPFOPFPDPPFPPPPOPFPPPPPPF
PPPPRPPPPPOPPPPPPPPPPPOPPPPPPPPPPOPPPPPPPOPPPPPPPPPPPPPPPPPPPPPPPPPPPPPPPPPPPPPP
PPPPPDPRPPPPPPPPPPPPPPPPPRPPPPPPPPPPPPPDPPPPPPOPPPPPPPPPPPPPPPPPPPPPPPPPPPPPPPPP
PPPPPPPPPPPPPPPPPPPPPPPPPPPPPPOPPRPRPPPPPDPPPPPPPPPPPDPPDPPPPPPPPPOPPPPPPPPPPPPP
PPPPPPPPPPPPPPPPPPPPPPPPPPPPPPPPPPOPPPPPPPPPPPPPPPPPPPOPPPPPDPPPDPPPPPPPPPPPPPPP
PPPP*******PPRPPPPPPPPPPPDPPPPPPPPPPPPPPPPPPPPPDPPPPPPPPPOPPPPDPPPPPPDPPPPPPPPPP
PPDPP*******PPPDPPPPPPPPPPPPPOPPPPPPPPPPPPPPPPPPPPPPPPPPPPPPOPPPPPPPPPPOPPPPPOPP
PPPPPPPPPP**PPPPPPPPPPPPPOPPPPPPDPPPPRPPPPPPPPPPPPPPPPPPPPPPPPPRPPPPPPPPPPPPPPPP
PPPPPPPPPPPPPPOPPPPOPPPPPPPDPPPPPPPPPPPPPPOPPPPPPOPPPPPPPPPPPPOPOPPPPPPPPPPPPPPP
POPPPPPPPOPPDPPPPPPPPPPPDPPPPPPPPPPPPPPPPPPOOPPPPPPDPPPPPPPPPPPPPPPPPPPPOPOPPOPP
PPPPPPPPPPPPPPPPPOPPPPPPPDPPPPPPPPPPPPRPPORPPPPPPPPPPPPPPPPPPPPPPPPPPPRPPPPPPPPP
PPPPPPPPPPPPDPPPPPPPPDRPPPPPPPPPRPPPPPPPPPPPPPPPPPPPPPPPPPPPPPPPPPPOOPPPPPPPPPPP
POPPPPPPPOPPPPPPPPPPPPPPPPPPPPPPPPPPPDPPPPOPPPPPPPOPPPPPPOPPPPPPPPPPPPPPPPPPPPPP
PPPPPPPOPPPPPPPOPPPPPPPPPPPPPPPPDPPPPPPPPPPPPPOPPOPPPPPPPPPPPPPPDPPPPDPOPPPPPPPP
PPPPPPPPPPPPPPPPPPPPPPPPPPPPPPPPPPPPPPPPPPPPPPPPPPPPPPPPPPPPPPPPPPPPPPPPPPPPPPPO
PPPPPOPOPPPPPPPPPDPPPPPPPPPPPPPPPPRPPPOPPPPPPPPPPPPPPPPPPPPPPPPPPPPPPPPPPPPPOPPP
PPPPPPPPPPPPPPPPPPOPPPPPPPPPPPPPPPPPPPPPPPPPPPPPOPPPPPPPPPPPPPPPPPPPPPPPPPPPPODP
PPPPPPPPPPPPPPOPOPPPPPDPPPPPPPPPOPPPRPPPPPPPPPPPPPOPPPPPPPPPPOPPDPPPRPPPPPPPPPPP
PPPPPPPPOPPPPPPPPOPDPPPPPPDPPPPPPOPPPRPPPPPPPPPPPDPPPPPPPPPOPPPPOPPPPPPPPPPPPPOP
PPPPPPPPPPPPPPPPPPPPPPPPOPPPPPPPPPPPPPPPPPPPPPPPPPPPPOPPPPPPPPPPPPPODPPPPPPPPPPP
PPPPPPPPPPPPPPPDPPOPPPPPPPPPPPPPPPPPPPPPPPPPPPPRPPPPPPPPPOPOPPPPPPPPPDPPPPPPPPPP
OPPPPPPPPPPPPPPPOPDPPPPPPPPPPDPPPPPPPPPPPPPPPPPPPPDPOPODPPPPPPPPPPPPPPPPPPPPPPPP
PPPPPPPPPOPPPPPDPPPPPPPPPPPPPPPPPPPPPPPPPPPPPPDPPPPPPPOPPPPPPPPPPPPPPPPOPPPPPPOP
PPPPPPPPPPOPPDPPPPPPPPPPDPPPPPOPPPPPPPPPPPPPPPPPPPDPPPPPOPPPPPOPPPPPPPPOPPPPPPOP
PPPPPPPPPPPPPPOPPPPPPPPPDPPPPPPPPPDPPPPPPPPDDPPPPPPPPPRPPPPPPPOPPPPPPPPPPPPPPPPP
PPPPPPPPPPOPPPPPPPPDPPPPPPPPPPPPPPPOPPOPPDPPPPPPPPPDPPPPOPPPPPPPPPPPPPPPPPPPPPPP
PPPPPPPPPPPPPPPPDPPPPPPPPPPPPPPPPPPPPPPPPPPPPPDPPPPPPPPPDPPPPPPRPPPOPPPPPPPPPPPP
PDPPOPOPPPPPPPPPPPPPP*******PPPPPPPPPPPPPPPPPPPPPPPPPPPPPDPPPPPPPPPPPPPPPPPPPPPP
PPOPPPPOOPPPPPPPPPPPPP*******PPPPPPPOPPPPPPPPPPPPPPPPPPPPPPPPPPPPPPPPPPPPPPPPPPP
PPPPPPPPPOPOPPPPPPPPPPPPPPP**PPPPPPPPPPPPPPPPPPPPPPPPPPPPPPPPPPPDPPDPPPPPPPPPPPP
PPOPPPPPPPPPPPPOPPPPPPPPPPPP*PPPPPPRPPPPPPPPPOPPPPPPPPP*******PPPPPPPDPPPPPPPPPP
PPPPPPPPPPPPPPPPPPPPPPPPPPPP*PPPDPPPPPPPPPPPDPPPPPOPOPPP*******PPPPPPRPDPPPPPPPP
PPPPPPPPPPPPOPPPPPP*******PP*PPPPRPPPPPPPPPPPPPPPPPPPPPPPPPPP**PPPPPOPPPPPPRDPPP
PPDRPPPPPPPPPPPPPRPP*******P*PPPPPPPPPPPPPPPPPPPPPPPPPPPPPPPPP*PPPPPPPPPPPDPPPPP
PPPPPPPPPPPPPPPPPPPPPPPPP**P*PPPPPPPPPPPPPPPDPPPPPPPPPPPPPPPPP*PPPPPPPPPPPPPPPPP
DOPPPOPPPPPPPPPPPPPPPPPPPP*PPPPPPPPPPPOPPPDPPPDPPPPPPPPPPPPPPP*PPPPPPPPPPPPPPPPP
PPPPPPPPPPPPPPPPPPPPPPPPPP*PPPPOPPPPPPPPPPPPPPPPPPPPPPP********PPPPPPPPPPPPPPOPP
PPPPPPPPPPPPPPPPPPPPPPPPPP*PPPPPPPPPPPPPDPPPPOPPPPPDPPPP*******PPPPPPOPPPPPPPPPP
PDPPPPPPPPPP*******PP******PPPPPPPPPPPPPPOPPPPPPPPPPPPPPPPPPPPPPPPPPPPOPPPPPPPPP
PPPOPRPPDPPPP*******P******PPOPPPPPPOPPPPPPPPPPPPPPPPPPPPPPPPPPPPPPPPPPPPPDPPPPP
PPPPPPPPPPPPPPPPPP**PPPPPPPPPPDPPPPPPPPPPPPPPPPPPPPPPPPPPPPPPPPPRPPRPPPPPPPPPPPP
PPPPPPPPPPPPPPPPPPP*POPPPPPOPPPPPP*******PPPP****PPPPPPPPPPPDPPPPPPPPPPPPPPDOPPP
PPPPPPPPPPPPPPPPPPP*PPPPPDDPPPPPPPP***********PP*PPPPPPPPPPPOPPPPPPPPOPPPPPPPPPP
PPPPPPPPPPPPPPPPPPP*POPPPPPPPPPPPPPPPPPPPPPPPP****PPPRPPPPPPPPPPRPPPPPPPPPPPPPPP
PDPPPPPPPPPP********PPPPPPPPPPPDPPPPPPPPPPPPPPPPP**PPPPPPPPPOPPPPPPPDPPPPPPPPPPO
PPPPOPPOPPOPP*******PPPPPPPPPPPPPPPPPPPPPPPPPPPPPPPPPPPPPPPOPORPPPPPPPPPPPPPPDPP
PPPPODPPPPPPPPPPPPPPPPPPPPPPPOPPPPPP**P*******PPPP****PPPPDPPPPPPPPPPPPPDPPPPRPP
PPPPPPPPDPPDPPPPPPPPPPPPPPPPPPPPPPPPPPPP***********PP*PPPPOPPPPPPPPPOPPPPPPPPPPP
PPPPPPPRPPPOPPPPPP*******PPPPPPDPPPPPPPPPPPPPPPPPPP****PPPPPPPPPPOPPPPPPOPPPPPPP
$$$$$$$$$$$$$$$$$$$$$$$$$$$$$$$$$$$$$$$$$$$$$$$$$$$$$$$$$$$$$$$$$$$$$$$$$$$$$$$$
