............................
............................
............................
............................
........####................
......######................
....########................
############################
